p	p
b	b
t	t
d	d
k	k
g	g
f	f
v	v
T	T
D	D
s	s
z	z
S	S
Z	Z
tS	tS
dZ	dZ
m	m
n	n
N	N
l	l
r	r
j	j
w	w
h	h
i:	i:
I	I
E	E
A	A
a:	a:
V	V
O	O
o:	o:
U	U
u:	u:
@:	@:
@	@
EI	ei
a:I	ai
@U	@u
@u:	@u
a:U	au
o:I	oi
I@	i@
e:	e:
U@	u@
a:I@	ai@
a:U@	au@
-	-
,	,