A, a	EI
a	@
A	EI
abandon	@`bAnd@n
abbreviation	@bri:vi:`EIS@n
ABC	EI bi: `si:
abdomen	`Abd@m@n
abide	@`ba:Id
ability	@`bIl@ti:
ablaze	@`blEIz
able	`EIb@l
abnormal	Ab`n@:m@l
abnormality	Abn@:`mAl@ti:
abolish	@`bOlIS
abominable	@`bOmn@b@l
aborigine	Ab@`rIdZ@ni:
abort	@`b@:t
abortion	@`b@:S@n
about	@`ba:Ut
above	@`bV v
abrasion	@`brEIZ@n
abroad	@`br@:d
abrupt	@`brV pt
abscess	`AbsEs, `Abs@s
absent	`Abs@nt
absent-minded	Abs@nt-`ma:Ind@d
absolute	`Abs@lu:t
absorb	@b`s@:b, -`z@:b
abstract	`AbstrAkt
absurd	@b`s@:d, -`z@:d
abuse	@`bju:z
accelerate	@k`sEl@rEIt, Ak-
accent	`AksEnt
accept	@k`sEpt
access	`a:ksEs
accident	`Aks@d@nt
accommodate	@`kOm@dEIt
accommodation	
accompany	@`kV mp@ni:, @`kV mpni:
accomplice	@`kV mpl@s, -`kOm-
accord	@`k@:d
accordingly	@`k@:dINli:
account	@`ka:u:nt
accountable	@`ka:Unt@b@l
accountant	@`ka:Unt@nt
accumulate	@`kju:mj@lEIt
accurate	`Akj@r@t
accuse	@`kju:z
accustomed	@`kV st@md
ace	EIs
ache	EIk
achieve	@`tSi:v
acid	`As@d
acknowledge	@k`nOlIdZ
acne	`Akni:
acoustics	@`ku:stIks
acquaint	@`kwEInt
acquaintance	@`kwEInt@ns
acquire	@`kwa:I@
acquit	@`kwIt
acre	`EIk@
acrobat	`Akr@bAt
acronym	`Akr@nIm
across	@`krOs
across-the-board	@`krOs-D@-b@:d
acrylic	@`krIlIk
act	Akt
ACT	EI si: `ti:
action	`AkS@n
activate	`Akt@vEIt
active	`AktIv
activity	Ak`tIv@ti:
actor	`Akt@
ACTU	EI si: ti: `ju:
actual	`AktSu:@l
actually	`AktSu:@li:, `AktS@li:
acupuncture	`Akj@pV NktS@, `Ak@-
acute	@`kju:t
acutely	@`kju:tli:
ad	Ad
AD	EI `di:
Adam's apple	`Ad@mz Ap@l
adapt	@`dApt
add	Ad
addict	`AdIkt
addicted	@`dIkt@d
addition	@`dIS@n
additive	`Ad@tIv
address	@`drEs
adequate	`Ad@kw@t
adhesive	@d`hi:sIv, -zIv
adjacent	@`dZEIs@nt
adjective	`AdZ@ktIv
adjourn	@`dZ@:n
adjudicate	@`dZu:d@kEIt
adjust	@`dZV st
adjustment	@`dZV stm@nt
admin	`AdmIn, Ad`mIn
administration	@dmIn@`strEIS@n
admire	@d`ma:I@
admission	@d`mIS@n
admit	@d`mIt
	@d`mItns
adolescence	Ad@`lEs@ns
adopt	@`dOpt
adore	@`d@:
adult	`AdV lt, @`dV lt
adultery	@`dV lt@ri:
advance	@d`vAns, -`va:ns
advanced	@d`vAnst, -`va:nst
advancement	@d`vAnsm@nt, -`va:ns-
advantage	@d`vAntIdZ, -`va:n-
adventure	@d`vEntS@
adverse	`Adv@:s, @d`v@:s
adversity	@d`v@:s@ti:
advertise	`Adv@ta:Iz
advertisement	@d`v@:t@sm@nt
advice	@d`va:Is
advisable	@d`va:Iz@b@l
advise	@d`va:Iz
advocate	`Adv@kEIt
	`E@ri:@l
aerobics	E@`r@UbIks
aerodrome	`E@r@dr@Um
aeroplane	`E@r@plEIn
aerosol	`E@r@sOl
affair	@`fE@
affect	@`fEkt
affectation	AfEk`tEIS@n
affected	@`fEkt@d
affection	@`fEkS@n
affirm	@`f@:m
affirmative	@`f@:m@tIv
affluent	`Aflu:@nt
afford	@`f@:d
afloat	@`fl@Ut
afraid	@`frEId
after	`a:ft@
after-effect	`a:ft@r-@fEkt
after-hours	`a:ft@r-a:U@z
afterlife	`a:ft@la:If
afternoon	a:ft@`nu:n
aftershave	`a:ft@SEIv
afterwards	`a:ft@w@dz
again	@`gEn
against	@`gEnst
age	EIdZ
aged	EIdZd
ageing	`EIdZIN
ageism	`EIdZIz@m
agency	`EIdZ@nsi:
agenda	@`dZEnd@
agent	`EIdZ@nt
aggravate	`Agr@vEIt
aggression	@`grES@n
aggressive	@`grEsIv
aggro	`Agr@U
agile	`AdZa:Il
agitate	`AdZ@tEIt
agnostic	Ag`nOstIk
ago	@`g@U
agony	`Ag@ni:
agree	@`gri:
agreement	@`gri:m@nt
agriculture	`Agr@kV ltS@
ahead	@`hEd
aid	EId
AIDS	EIdz
aim	EIm
aimless	`EIml@s
air	E@
airconditioning	`E@k@ndIS@nIN
aircraft	`E@kra:ft
aircraft carrier	`E@kra:ft `kAri:@
air force	`E@ f@:s
airlift	`E@lIft
airline	`E@la:In
airmail	`E@mEIl
airport	`E@p@:t
air raid	`E@ rEId
air traffic control	;E@ trAfIk k@n`tr@Ul
aisle	a:Il
ajar	@`dZa:
alarm	@`la:m
alarm clock	@`la:m klOk
alarmist	@`la:m@st
album	`Alb@m
alcohol	`Alk@hOl
alcoholic	AlIk
ale	EIl
alert	@`l@:t
algebra	`AldZ@br@
alias	`EIli:@s
alibi	`Al@ba:I
alien	`EIli:@n
alienate	`EIli:@nEIt
alight	@`la:It
align	@`la:In
alike	@`la:Ik
alive	@`la:Iv
alkali	`Alk@la:I
all	@:l
allege	@`lEdZ
allegiance	@`li:dZ@ns
allegory	`Al@g@ri:, -gri:
allergy	`Al@dZi:
alleviate	@`li:vi:EIt
alley	`Ali:
alliance	@`la:I@ns
allocate	`Al@kEIt
allot	@`lOt
allow	@`la:U
allowance	@`la:U@ns
all right	@:l `ra:It
allure	@`lu:@, @`lju:@
ally	`Ala:I
almighty	@:l`ma:Iti:
almost	`@:lm@Ust
alone	@`l@Un
along	@`lON
aloud	@`la:Ud
ALP	EI El `pi:
alphabet	`Alf@bEt
alpine	`Alpa:In
already	@:l`rEdi:
alright	@:l`ra:It
also	`@:ls@U
altar	`Olt@, `@:l-
alter	`Olt@, `@:l-
altercation	Olt@`kEIS@n, @:l-
alternate	Ol`t@:n@t
alternative	Ol`t@:n@tIv, @:l-
although	@:l`D@U
altitude	`Alt@tju:d
altogether	@:lt@`gED@
aluminium	Alj@`mInj@m
always	`@:lwEIz, -w@z
am	Am
AM	EI `Em
a.m.	EI `Em
AMA	EI Em `EI
amalgamate	@`mAlg@mEIt
amass	@`mAs
amateur	`Am@t@, `Am@tS@
amaze	@`mEIz
ambassador	Am`bAs@d@
amber	`Amb@
ambiguous	Am`bIgju:@s
ambition	Am`bIS@n
amble	`Amb@l
ambulance	`Ambj@l@ns
ambush	`AmbUS
amenable	@`mEn@b@l, @`mi:n-
amend	@`mEnd
amenity	@`mEn@ti:, @`mi:n-
amiable	`EImi:@b@l
amicable	`AmIk@b@l
ammonia	@`m@Uni:@, -j@
ammunition	Amj@`nIS@n
amnesia	Am`ni:Z@
among	@`mV N
amorous	`Am@r@s
amount	@`ma:Unt
ample	`Amp@l
amplify	`Ampl@fa:I
amputate	`Ampj@tEIt
amputee	;Ampju:`ti:
amuse	@`mju:z
amusement	@`mju:zm@nt
an	An
anaemia	@`ni:mi:@
anaesthetic	An@s`TEtIk
anal	`EIn@l
analgesic	An@l`dZi:zIk
analogy	@`nAl@dZi:
analysis	@`nAl@s@s
anarchy	`An@ki:
anatomy	@`nAt@mi:
ancestor	`AnsEst@
anchor	`ANk@
anchorage	`ANk@rIdZ
ancient	`EInS@nt
and	And
anecdote	`An@kd@Ut
angel	`EIndZ@l
anger	`ANg@
angle	`ANg@l
angry	`ANgri:
anguish	`ANgwIS
animal	`An@m@l
animated	`An@mEIt@d
animosity	An@`mOs@ti:
ankle	`ANk@l
annex	`AnEks
annexe	`AnEks
annihilate	@`na:I@lEIt
anniversary	An@`v@:s@ri:
announce	@`na:Uns
annoy	@`n@:I
annual	`Anju:@l
anonymous	@`nOn@m@s
another	@`nV D@
answer	`Ans@, `a:n-
ant	Ant
antagonise	An`tAg@na:Iz
antagonistic	AntAg@`nIstIk
antenna	An`tEn@
anthem	`AnT@m
anthropologist	AnTr@`pOl@dZ@st
anti-	`Anti:
antibiotic	Anti:ba:I`OtIk
anticipate	An`tIs@pEIt
anticlockwise	Anti:`klOkwa:Iz
antics	`AntIks
antidote	`Anti:d@Ut
antihistamine	Anti:`hIst@mi:n, -ma:In
antipathy	An`tIp@Ti:
antipodes	An`tIp@di:z
antiquated	`Ant@kwEIt@d
antique	An`ti:k
antiseptic	Ant@`sEptIk
antithesis	An`tIT@s@s
antler	`Antl@
antonym	`Ant@nIm
anus	`EIn@s
anxious	`ANS@s, `ANk-
any	`Eni:
anybody	`Eni:bOdi:, -b@di:
anyhow	`Eni:ha:U
anyone	`Eni:wV n
anything	`Eni:TIN
anyway	`Eni:wEI
anywhere	`Eni:wE@
Anzac	`AnzAk
apart	@`pa:t
apartheid	@`pa:tEIt
apartment	@`pa:tm@nt
apathy	`Ap@Ti:
ape	EIp
apex	`EIpEks
apocalypse	@`pOk@lIps
apologise	@`pOl@dZa:Iz
apology	@`pOl@dZi:
apostle	@`pOs@l
apostrophe	@`pOstr@fi:
appal	@`p@:l
apparatus	Ap@`ra:t@s, -`rEIt@s
apparent	@`pAr@nt
apparition	Ap@`rIS@n
appeal	@`pi:l
appear	@`pI@
appearance	@`pI@r@ns
appease	@`pi:z
append	@`pEnd
appendicitis	@pEnd@`sa:It@s
appendix	@`pEndIks
appetising	`Ap@ta:IzIN
appetite	`Ap@ta:It
applause	@`pl@:z
apple	`Ap@l
appliance	@`pla:I@ns
applicable	@`plIk@b@l, `Ap-
applicant	`Apl@k@nt
apply	@`pla:I
appoint	@`p@:Int
appointment	@`p@:Intm@nt
appreciate	@`pri:Si:EIt, @`pri:si:-
apprehend	Apr@`hEnd
apprehension	Apr@`hEnS@n
apprentice	@`prEnt@s
approach	@`pr@UtS
approachable	@`pr@UtS@b@l
appropriate	@`pr@Upri:@t
approval	@`pru:v@l
approximate	@`prOks@m@t
Apr.	`EIpr@l
April	`EIpr@l
apron	`EIpr@n
apt	Apt
aptitude	`Apt@tSu:d
aquarium	@`kwE@ri:@m
Arabic	`Ar@bIk
arbitrary	`a:b@tr@ri:, `a:b@tri:
arbitration	a:b@`trEIS@n
	a:k
arcade	a:`kEId
arch	a:tS
archaeologist	a:ki:`Ol@dZ@st
archaic	a:`kEIIk
architect	`a:k@tEkt
Arctic Circle	a:ktIk `s@:k@l
arduous	`a:dZu:@s
are	a:
area	`E@ri:@
arena	@`ri:n@
arguable	`a:gju:@b@l
argue	`a:gju:
argument	`a:gj@m@nt
arise	@`ra:Iz
aristocracy	Ar@`stOkr@si:
arithmetic	@`rITm@tIk
ark	a:k
arm	a:m
armchair	`a:mtSE@
armed	a:md
armful	`a:mfUl
armhole	`a:mh@Ul
armistice	`a:m@st@s
armour	`a:m@
armpit	`a:mpIt
army	`a:mi:
aroma	@`r@Um@
around	@`ra:Und
arousal	@`ra:Uz@l
arouse	@`ra:Uz
arrange	@`rEIndZ
arrangement	@`rEIndZm@nt
array	@`rEI
arrest	@`rEst
arrival	@`ra:Iv@l
arrive	@`ra:Iv
arrogant	`Ar@g@nt
arrow	`Ar@U
arse	a:s
arsenal	`a:s@n@l
arsenic	`a:s@nIk
arson	`a:s@n
art	a:t
artery	`a:t@ri:
arthritis	a:`Tra:It@s
article	`a:tIk@l
artificial	a:t@`fIS@l
artist	`a:t@st
art union	`a:t ju:nj@n
arvo	`a:v@U
as	Az
asbestos	@s`bEst@s, As-
ascend	@`sEnd
ascent	@`sEnt
ascertain	As@`tEIn
ash	AS
ashamed	@`SEImd
aside	@`sa:Id
ask	a:sk
asleep	@`sli:p
asparagus	@`spAr@g@s
aspect	`AspEkt
asphalt	`ASfElt
aspire	@`spa:I@
aspirin	`Aspr@n
ass	As
assassin	@`sAs@n
assassinate	@`sAs@nEIt
assault	@`sOlt
assemble	@`sEmb@l
assembly	@`sEmbli:
assent	@`sEnt
assert	@`s@:t
assertive	@`s@:tIv
assess	@`sEs
asset	`As@t
assign	@`sa:In
assignment	@`sa:Inm@nt
assimilate	@`sIm@lEIt
assist	@`sIst
associate	@`s@USi:EIt, @`s@Usi:EIt
association	@s@Usi:`EIS@n
assortment	@`s@:tm@nt
assume	@`sju:m
assurance	@`S@:r@ns, -`SU@-
assure	@`S@:
asterisk	`Ast@rIsk
asthma	`a:sm@
astonish	@`stOnIS
astound	@`sta:Und
astray	@`strEI
astrology	@s`trOl@dZi:
astronaut	`Astr@n@:t
astronomy	@s`trOn@mi:
astute	@s`tju:t
asylum	@`sa:Il@m
at	At
ate	EIt
atheist	`EITi:@st
athlete	`ATli:t
atlas	`Atl@s
ATM	EI ti: `Em
atmosphere	`Atm@sfI@
atom	`At@m
atomic	@`tOmIk
atrocious	@`tr@US@s
attach	@`tAtS
attack	@`tAk
attain	@`tEIn
attempt	@`tEmpt
attend	@`tEnd
attention	@`tEnS@n
attic	`AtIk
attire	@`ta:I@
attitude	`At@tju:d
attract	@`trAkt
attractive	@`trAktIv
attribute	@`trIbju:t
atypical	EI`tIpIk@l
aubergine	`@Ub@dZi:n
auburn	`@:b@n
auction	`OkS@n
audacious	@:`dEIS@s
audible	`@:d@b@l
audience	`@:di:@ns
audio	`@:di:@U
audit	`@:d@t
audition	@:`dIS@n
Aug.	`@:g@st
August	`@:g@st
august	@:`gV st
aunt	a:nt
aura	`@:r@
auspicious	@:`spIS@s, @-
austere	Os`tI@
Australian	@st`rEIlj@n
Australian Democrats	@strEIlj@n `dEm@krAts
Australian Labor Party	@strEIlj@n `lEIb@ pa:ti:
authentic	@:`TEntIk
author	`@:T@
authorise	`@:T@ra:Iz
authority	@:`TOr@ti:, @-
autobiography	@:t@ba:I`Ogr@fi:
autograph	`@:t@grAf, -gra:f
automatic	@:t@`mAtIk
automobile	`@:t@m@bi:l
autonomous	@:`tOn@m@s
autopsy	`@:tOpsi:
autumn	`@:t@m
auxiliary	Og`zIlj@ri:
avail	@`vEIl
available	@`vEIl@b@l
avalanche	`Av@lAnS, -la:nS
Ave	`Av@nju:
avenge	@`vEndZ
avenue	`Av@nju:
average	`Av@rIdZ, -vrIdZ
averse	@`v@:s
aversion	@`v@:Z@n
avert	@`v@:t
aviation	EIvi:`EIS@n
avid	`Av@d
avocado	Av@`ka:d@U
avoid	@`v@:Id
await	@`wEIt
awake	@`wEIk
awaken	@`wEIk@n
award	@`w@:d
aware	@`wE@
away	@`wEI
awe	@:
awful	`@:f@l
awhile	@`wa:Il
awkward	`@:kw@d
awning	`@:nIN
axe	Aks
axis	`Aks@s
axle	`Aks@l
B, b	bi:
B	bi:
b.	
babble	`bAbl
	`bEIbi:
babysit	`bEIbi:sIt
bachelor	`bAtS@l@
back	bAk
backbone	`bAkb@Un
backdate	`bAkdEIt
backfire	bAk`fa:I@
background	`bAkgra:Und
backing	`bAkIN
backlog	`bAklOg
backside	bAk`sa:Id
backstop	`bAkstOp
backstroke	`bAkstr@Uk
backup	`bAkV p
backward	`bAkw@d
backwards	`bAkw@dz
backyard	bAk`ja:d
bacon	`bEIk@n
bacteria	bAk`tI@ri:@
bad	bAd
bade	bAd
badge	bAdZ
badger	`bAdZ@
baffle	`bAfl
bag	bAg
baggage	`bAgIdZ
Bahasa Indonesia	b@ha:s@ Ind@`ni:Z@
bail	bEIl
bait	bEIt
	bEIk
baking powder	`bEIkIN pa:Ud@
baking soda	`bEIkIN s@Ud@
balance	`bAl@ns
balanced	`bAl@nst
balcony	`bAlk@ni:
bald	b@:ld
bale	bEIl
ball	
ballast	`bAl@st
ballet	`bAlEI
balloon	
[xthead,ballot	`bAl@t
ballpoint pen	b@:lp@:Int `pEn
balmy	`ba:mi:
bamboozle	bAm`bu:zl
ban	bAn
band	bAnd
bandage	
	`bAndEId
bandicoot	`bAndi:ku:t
bandit	`bAnd@t
bang	bAN
banjo	`bAndZ@U
bank	bANk
bankrupt	`bANkrV pt
banksia	`bANksi:@
	`bAn@
banquet	`bANkw@t
baptism	`bAptIzm
bar	ba:
barb	ba:b
barbarian	ba:`bE@ri:@n
barbecue	`ba:b@kju:
barber	`ba:b@
barbiturate	ba:`bItSUr@t
bar code	`ba: k@Ud
bare	bE@
barely	`bE@li:
bargain	`ba:g@n
barge	ba:dZ
baritone	`bAr@t@Un
bark	ba:k
barn	ba:n
barometer	b@`rOm@t@
barrack	`bAr@k
barracks	`bAr@ks
barrage	`bAra:Z, -a:dZ
barrel	`bAr@l
barren	`bAr@n
barrier	`bAri:@
barrister	`bAr@st@
barrow	`bAr@U
base	bEIs
baseball	`bEIsb@:l
basement	`bEIsm@nt
bash	bAS
bashful	`bASfUl
basic	`bEIsIk
basin	`bEIs@n
basis	`bEIsi:z
bask	ba:sk
basket	`ba:sk@t
basketball	`ba:sk@tb@:l
bass	bEIs
bassinette	bAs@`nEt
bastard	`ba:st@d
	bAt
batch	bAtS
bath	ba:T
bathe	bEID
bathers	`bEID@z
bathroom	`ba:Tru:m
baton	`bAtn
battalion	b@`tAlj@n
batten	`bAtn
batter	`bAt@
	
battle	`bAtl
baulk	b@:k
bawdy	`b@:di:
bawl	b@:l
bay	bEI
bayonet	`bEI@nEt
BBQ	`ba:b@kju:
BC	bi: `si:
be	bi:
beach	bi:tS
beach inspector	`bi:tS InspEkt@
beacon	`bi:k@n
bead	bi:d
beak	bi:k
beam	bi:m
bear	bE@
beard	bI@d
bearing	`bE@rIN
beast	bi:st
beat	bi:t
beaut	bju:t
beautician	bju:`tIS@n
beautiful	`bju:t@f@l
beauty	`bju:ti:
became	b@`kEIm
because	
beckon	`bEk@n
become	b@`kV m, bi:-
becoming	b@`kV mIN, bi:-
bed	bEd
bedding	`bEdIN
bedraggled	b@`drAg@ld
bedridden	`bEdrIdn
bedroom	`bEdru:m
bee	bi:
beef	bi:f
been	bi:n
beer	bI@
before	b@`f@:
befriend	b@`frEnd
beg	bEg
began	b@`gAn
begin	b@`gIn
beginner	b@`gIn@
begrudge	b@`grV dZ, bi:-
begun	b@`gV n
behalf	b@`ha:f
behave	b@`hEIv, bi:-
behind	b@`ha:Ind, bi:-
beige	bEIZ
being	`bi:IN
belated	b@`lEIt@d
belch	bEltS
belief	b@`li:f
believe	b@`li:v
belittle	b@`lItl
bell	bEl
belligerent	b@`lIdZ@r@nt
bellow	`bEl@U
belly	`bEli:
bellybutton	`bEli:bV t@n
belong	b@`lON
belongings	b@`lONINz
beloved	b@`lV v@d
below	b@`l@U
belt	bElt
bench	bEntS
bend	bEnd
beneath	b@`ni:T
benefactor	`bEn@fAkt@
beneficial	bEn@`fIS@l
beneficiary	bEn@`fIS@ri:
benefit	`bEn@f@t
benevolent	b@`nEv@l@nt
benign	b@`na:In
bent	bEnt
bequeath	b@`kwi:D, -`kwi:T
bereaved	b@`ri:vd
bereft	b@`rEft
beret	`bErEI
berry	`bEri:
berserk	b@`z@:k
berth	b@:T
beside	b@`sa:Id
besides	b@`sa:Idz
besiege	
best	bEst
best man	bEst `mAn
bet	bEt
betray	b@`trEI, bi:-
better	`bEt@
between	b@`twi:n
beverage	`bEvrIdZ, `bEv@rIdZ
	b@`wE@, bi:-
bewildered	b@`wIld@d, bi:-
bewitch	b@`wItS, bi:-
beyond	b@`jOnd, bi:-
biannual	ba:I`Anju:@l
bias	`ba:I@s
bib	bIb
Bible	`ba:Ib@l
bibliography	bIbli:`@gr@fi:
bicentenary	ba:IsEn`ti:n@ri:, -`tEn@ri:
bicentennial	ba:Is@n`tEni:@l
biceps	`ba:Is@ps, -sEps
bicker	`bIk@
bicycle	`ba:IsIk@l
bid	bId
bide	ba:Id
biennial	ba:I`Eni:@l
	ba:I`f@Uk@lz
big	bIg
bigamy	`bIg@mi:
biggie	`bIgi:
bight	ba:It
bigot	`bIg@t
bike	ba:Ik
bikini	b@`ki:ni:
bile	ba:Il
bilingual	ba:I`lINgw@l
bilious	`bIlj@s
bill	bIl
billabong	`bIl@bON
billboard	`bIlb@:d
billet	`bIl@t
billiards	`bIlj@dz
billion	`bIlj@n
billow	`bIl@U
billy	`bIli:
bin	bIn
bind	ba:Ind
bindi-eye	`bIndi:-a:I
bingo	`bINg@U
binoculars	b@`nOkj@l@z
biodegradable	ba:I@Ud@`grEId@b@l
biography	ba:I`Ogr@fi:
biologist	ba:I`Ol@dZ@st
biopsy	`ba:IOpsi:
bird	b@:d
biro	`ba:Ir@U
birth	b@:T
birthday	`b@:TdEI
biscuit	`bIsk@t
bisect	ba:I`sEkt
bisexual	ba:I`sEkSu:@l
bishop	`bIS@p
bistro	`bIstr@U
bit	bIt
bitch	bItS
bite	ba:It
bitter	`bIt@
bitumen	`bItS@m@n
bivouac	`bIvu:Ak
bizarre	b@`za:
blab	blAb
blackboard	`blAkb@:d
blackhead	`blAkhEd
blackmail	`blAkmEIl
blackout	`blAka:Ut
black sheep	blAk `Si:p
blacksmith	`blAksmIT
bladder	`blAd@
blade	blEId
blame	blEIm
bland	blAnd
blank	blANk
blanket	`bla:Nk@t
blare	blE@
blaspheme	blAs`fi:m
blast	bla:st
blatant	`blEIt@nt
blaze	blEIz
blazer	`blEIz@
bleach	bli:tS
bleak	bli:k
bleary	`blI@ri:
bleat	bli:t
bleed	bli:d
blemish	`blEmIS
blend	blEnd
blender	`blEnd@
bless	blEs
blessing	`blEsIN
blew	blu:
blight	bla:It
blind	bla:Ind
blindfold	`bla:Indf@Uld
blink	blINk
blinker	`blINk@
bliss	blIs
blister	`blIst@
blistering	`blIst@rIN
blitz	blIts
blizzard	`blIz@d
bloated	`bl@Ut@d
bloc	blOk
block	blOk
blockade	blO`kEId
blockbuster	`blOkbV st@
bloke	bl@Uk
blond	blOnd
blonde	blOnd
blood	blV d
bloodbath	`blV dba:T
bloodshed	`blV dSEd
bloodshot	`blV dSOt
bloodstream	`blV dstri:m
bloodthirsty	`blV dT@:sti:
bloody	`blV di:
bloody-minded	blV di:-`ma:Ind@d
bloom	blu:m
blossom	`blOs@m
blot	blOt
blouse	bla:Uz
blow	bl@U
blowout	`bl@Ua:Ut
blowtorch	`bl@Ut@:tS
blubber	`blV b@
bludge	blV dZ
bludgeon	`blV dZ@n
blue	blu:
bluebottle	`blu:bOtl
blue-collar	`blu:-kOl@
blue metal	`blu: mEtl
blue movie	blu: `mu:vi:
blueprint	`blu:prInt
blue-ringed octopus	;blu:-rINd `Okt@p@s
blues	blu:z
bluff	blV f
blunder	`blV nd@
blunt	blV nt
blur	bl@:
blurb	bl@:b
blurt	bl@:t
blush	blV S
bluster	`blV st@
BMX	bi: Em `Eks
board	b@:d
boarder	`b@:d@
boast	b@Ust
boat	b@Ut
bob	bOb
bobbin	`bOb@n
bobby pin	`bObi: pIn
bodice	`bOd@s
body	`bOdi:
bodyguard	`bOdi:ga:d
bog	bOg
bogus	`b@Ug@s
bogy	`b@Ugi:
boil	b@:Il
boiler	`b@:Il@
boilersuit	`b@:Il@su:t
boisterous	`b@:Istr@s
bold	b@Uld
bolster	`b@Ulst@
	b@Ult
bomb	bOm
bombard	bOm`ba:d
bombshell	`bOmSEl
bona fide	b@Un@ `fa:Idi:
bond	bOnd
bone	b@Un
bonfire	`bOnfa:I@
bongo	`bONg@U
bonnet	`bOn@t
bonus	`b@Un@s
boob	bu:b
boobook	`bu:bUk
booby prize	`bu:bi: pra:Iz
booby trap	`bu:bi: trAp
book	bUk
bookcase	`bUkkEIs
bookkeeping	`bUkki:pIN
bookmaker	`bUkmEIk@
bookstall	`bUkst@:l
bookworm	`bUkw@:m
boom	bu:m
boomer	`bu:m@
boomerang	`bu:m@rAN
boon	bu:n
boor	b@:
boost	bu:st
boot	bu:t
booth	bu:D
booty	`bu:ti:
booze	bu:z
border	`b@:d@
borderline	`b@:d@la:In
bore	b@:
born	b@:n
borne	b@:n
boronia	b@`r@Uni:@
borough	`bV r@
borrow	`bOr@U
bosom	`bUz@m
boss	bOs
botanist	`bOt@n@st
botch	bOtS
both	b@UT
bottle	`bOtl
bottlebrush	`bOtlbrV S
bottleneck	`bOtlnEk
bottom	`bOt@m
bough	ba:U
bought	b@:t
boulder	`b@Uld@
boulevard	`bu:l@va:d
bounce	ba:Uns
bouncing	`ba:UnsIN
bouncy	`ba:Unsi:
bound	ba:Und
boundary	`ba:Undri:
bounty	`ba:Unti:
bouquet	bu:`kEI, b@u:`kEI
bourgeois	`bU@Zwa:, `bu:-
bout	ba:Ut
boutique	bu:`ti:k
bow	b@U
bowel	`ba:U@l
bowerbird	`ba:U@b@:d
bowl	b@Ul
bowling	`b@UlIN
bowls	b@Ulz
bowser	`ba:Uz@
box	bOks
boxer	`bOks@
box jellyfish	bOks `dZEli:fIS
box office	`bOks Of@s
boy	b@:I
boycott	`b@:IkOt
boyfriend	`b@:IfrEnd
bra	bra:
	brEIs
bracelet	`brEIsl@t
bracken	`brAk@n
bracket	`brAk@t
brag	brAg
braid	brEId
braille	brEIl
brain	brEIn
brainstorm	`brEInst@:m
brainwash	`brEInwOS
brainwave	`brEInwEIv
braise	brEIz
brake	brEIk
bran	brAn
branch	brAntS, bra:ntS
brand	brAnd
brash	brAS
brass	bra:s
brassiere	`brAzi:@
brat	brAt
bravado	br@`va:d@U
brave	brEIv
brawl	br@:l
brawn	br@:n
brazen	`brEIz@n
breach	bri:tS
bread	brEd
bread-and-butter	brEd-@n-`bV t@
breadline	`brEdla:In
breadth	brEdT
breadwinner	`brEdwIn@
break	brEIk
breakable	`brEIk@b@l
breakdown	`brEIkda:Un
breakfast	`brEkf@st
break-in	`brEIk-In
breakthrough	`brEIkTru:
bream	brIm
breast	brEst
breaststroke	`brEststr@Uk
breath	brET
breathalyser	`brET@la:Iz@
breathe	bri:D
breathtaking	`brETtEIkIN
breath test	`brET tEst
breed	bri:d
breeze	bri:z
breezy	`bri:zi:
brevity	`brEv@ti:
brew	bru:
brewery	`bru:@ri:
bribe	bra:Ib
brick	brIk
brickie	`brIki:
bricklayer	`brIklEI@
brick-veneer	brIk-v@`nI@
bride	bra:Id
bridegroom	`bra:Idgru:m
bridesmaid	`bra:IdzmEId
bridge	brIdZ
bridle	`bra:Idl
brief	bri:f
briefcase	`bri:fkEIs
bright	bra:It
brilliant	`brIlj@nt
brim	brIm
brine	bra:In
bring	brIN
brink	brINk
brisk	brIsk
bristle	`brIsl
brittle	`brItl
broach	br@UtS
broad	br@:d
broadcast	`br@:dka:st
broad-minded	br@:d-`ma:Ind@d
broccoli	`brOk@li:, -la:I
brochure	`br@US@, br@`SU@
broke	br@Uk
broken	`br@Uk@n
brolga	`brOlg@
brolly	`brOli:
bronchitis	brON`ka:It@s
bronze	brOnz
brooch	br@UtS
brood	bru:d
broom	bru:m
bros.	`brV D@z
broth	brOT
brothel	`brOT@l
brother	`brV D@
brother-in-law	`brV D@r-In-l@:
brought	br@:t
brow	bra:U
browbeat	`bra:Ubi:t
brown	bra:Un
browse	bra:Uz
bruise	bru:z
brumby	`brV mbi:
brunch	brV ntS
brunette	bru:`nEt
brunt	brV nt
brush	brV S
brussels sprout	brV s@lz `spra:Ut
brutal	`bru:t@l
brute	bru:t
bubble	`bV b@l
bubbler	`bV bl@
buck	bV k
bucket	`bV k@t
	`bV kl
bucktooth	bV k`tu:T
bud	bV d
Buddhism	`bUdIz@m
buddy	`bV di:
budge	bV dZ
budgerigar	`bV dZ@ri:ga:
budget	`bV dZ@t
budgie	`bV dZi:
buff	bV f
buffer	`bV f@
buffet	`bV fEI
buffoon	b@`fu:n
bug	bV g
bugbear	`bV gbE@
bugger	`bV g@
bugle	`bju:g@l
build	bIld
building	`bIldIN
building society	`bIldIN s@sa:I@ti:
built-up area	bIlt-V p `E@ri:@
bulb	bV lb
bulge	bV ldZ
bulk	bV lk
bull	bUl
bullbar	`bUlba:
bulldozer	`bUld@Uz@
bullet	`bUl@t
bulletin	`bUl@t@n
bullion	`bUlj@n
bullock	`bUl@k
bullseye	`bUlza:I
bullshit	`bUlSIt
bully	`bUli:
bum	bV m
bumble	`bV mb@l
bump	bV mp
bumper	`bV mp@
bun	bV n
bunch	bV ntS
bundle	`bV ndl
bundy	`bV ndi:
bung	bV N
bungalow	`bV Ng@l@U
bungle	`bV Ng@l
bunion	`bV nj@n
bunk	bV Nk
bunker	`bV Nk@
bunny	`bV ni:
bunyip	`bV nj@p
buoy	b@:I
buoyant	`b@:I@nt
burble	`b@:b@l
burden	`b@:dn
bureau	`bju:r@U, bju:`r@U
bureaucracy	bju:`rOkr@si:
bureaucrat	`bju:r@krAt
burglar	`b@:gl@
burial	`bEri:@l
burl	b@:l
burly	`b@:li:
burn	b@:n
burnish	`b@:nIS
burp	b@:p
burr	b@:
burrow	`bV r@U
bursar	`b@:s@
bursary	`b@:s@ri:
burst	b@:st
bury	`bEri:
bus	bV s
bush	bUS
bush band	`bUS bAnd
bushed	bUSt
bushfire	`bUSfa:I@
bushie	`bUSi:
bushman	`bUSm@n
bushranger	`bUSrEIndZ@
bushwalk	`bUSw@:k
bushwhacker	`bUSwAk@
business	`bIzn@s
businesslike	`bIzn@sla:Ik
busker	`bV sk@
bust	bV st
bustard	`bV st@d
bustle	`bV s@l
busy	`bIzi:
busybody	`bIzi:bOdi:
but	bV t
butane	`bju:tEIn
butch	bUtS
butcher	`bUtS@
butcherbird	`bUtS@b@:d
butt	bV t
butter	`bV t@
butterfly stroke	`bV t@fla:I str@Uk
buttocks	`bV t@ks
	`bV t@n
buttress	`bV tr@s
buy	ba:I
buzz	bV z
bvd	
by	ba:I
bye	ba:I
by-election	`ba:I-@lEkS@n
by-law	`ba:I-l@:
BYO	bi: wa:I `@U
bypass	`ba:Ipa:s
by-product	`ba:I-prOdV kt
bystander	`ba:IstAnd@
byte	ba:It
byword	`ba:Iw@:d
C, c	si:
C	si:
cab	kAb
cabbage	`kAbIdZ
cabin	`kAb@n
cabinet	`kAb@n@t, `kAbn@t
cable	`kEIb@l
cackle	`kAk@l
cadet	k@`dEt
cadge	kAdZ
caesarean section	s@;zE@ri:@n `sEkS@n
cafe	`kAfEI
cafeteria	kAf@`tI@ri:@
cage	kEIdZ
cagey	`kEIdZi:
cake	kEIk
calamari	
calamity	k@`lAm@ti:
calcium	`kAlsi:@m
calculate	`kAlkj@lEIt
calculating	`kAlkj@lEItIN
calculator	`kAlkj@lEIt@
calendar	`kAl@nd@
calf	ka:f
call	k@:l
callgirl	`k@:lg@:l
callous	`kAl@s
calm	ka:m
calorie	`kAl@ri:
came	kEIm
camera	`kAmr@, `kAm@r@
camouflage	`kAm@fla:Z, -fla:dZ
camp	kAmp
campaign	kAm`pEIn
campus	`kAmp@s
can	kAn
canal	k@`nAl
cancel	`kAns@l
cancer	`kAns@
candid	`kAnd@d
candidate	`kAnd@dEIt, -d@t
	`kAndl
candour	`kAnd@
cane	kEIn
cane toad	`kEIn t@Ud
canine	`kEIna:In
cannabis	`kAn@b@s
cannon	`kAn@n
cannot	`kAnOt, k@`nOt
canoe	k@`nu:
canopy	`kAn@pi:
can't	ka:nt
canteen	kAn`ti:n
canter	`kAnt@
canvas	`kAnv@s
canyon	`kAnj@n
	kAp
capable	`kEIp@b@l
capacity	k@`pAs@ti:
cape	kEIp
capital	`kAp@tl
capitalise	`kAp@t@la:Iz
capitalism	`kAp@t@lIz@m
capsicum	`kAps@k@m
capsize	kAp`sa:Iz
capsule	`kApSu:l, -S@l
captain	`kApt@n
caption	`kApS@n
captivate	`kApt@vEIt
captive	`kAptIv
captivity	kAp`tIv@ti:
capture	`kAptS@
car	ka:
carafe	k@`ra:f, -`rAf, `kAr@f
caramel	`kAr@m@l
carat	`kAr@t
caravan	`kAr@vAn
carbohydrate	ka:b@`ha:IdrEIt
carbon	`ka:b@n
carburettor	ka:bj@`rEt@, ka:b@-
carcass	`ka:k@s
carcinogen	ka:`sIn@dZ@n
card	ka:d
cardboard	`ka:db@:d
cardiac	`ka:di:Ak
cardigan	`ka:dIg@n
cardinal number	ka:d@n@l `nV mb@
care	kE@
career	k@`rI@
careful	`kE@f@l
careless	`kE@l@s
caress	k@`rEs
caretaker	`kE@tEIk@
cargo	`ka:g@U
caricature	`kAr@k@tSU@
carnage	`ka:nIdZ
carnival	`ka:n@v@l
carol	`kAr@l
car park	`ka: pa:k
carpenter	`ka:p@nt@
carpet	`ka:p@t
carriage	`kArIdZ
carry	`kAri:
cart	ka:t
cartilage	`ka:t@lIdZ, `ka:tlIdZ
carton	`ka:tn
cartoon	ka:`tu:n
cartridge	`ka:trIdZ
carve	ka:v
case	kEIs
cash	kAS
cashier	kA`SI@
casino	k@`si:n@U
cask	ka:sk
casserole	`kAs@r@Ul
cassette	k@`sEt
cast	ka:st
caste	ka:st
castle	`ka:s@l, `kAs@l
castor	`ka:st@
castrate	`kAstrEIt, `ka:s-
casual	`kAZju:@l
casualty	`kAZju:@lti:
cat	kAt
catalogue	`kAt@lOg
casuarina	kAZj@`ri:n@
catapult	`kAt@pV lt
cataract	`kAt@rAkt
catarrh	k@`ta:
catastrophe	k@`tAstr@fi:
catch	kAtS
category	`kAt@g@ri:, -t@gri:
cater	`kEIt@
cathedral	k@`Ti:dr@l
cattle	`kAtl
caucus	`k@:k@s
caught	k@:t
cauliflower	`kOli:fla:U@
cause	k@:z
causeway	`k@:zwEI
caustic	`kOstIk
cauterise	`k@:t@ra:Iz
cautious	`k@:S@s
cavalry	`kAv@lri:
cave	kEIv
cavern	`kAv@n
cavity	`kAv@ti:
CD	si: `di:
cease	si:s
ceasefire	`si:sfa:I@
ceiling	`si:lIN
celebrate	`sEl@brEIt
celebrated	`sEl@brEIt@d
celebrity	s@`lEbr@ti:
celery	`sEl@ri:
celibacy	`sEl@b@si:
cell	sEl
cellar	`sEl@
Celsius	`sElsi:@s
cement	s@`mEnt
cemetery	`sEm@tri:
censor	`sEns@
censure	`sEnS@
census	`sEns@s
cent	sEnt
centenary	sEn`ti:n@ri:, -`tEn-
centigrade	`sEnt@grEId
centimetre	`sEnt@mi:t@
central	`sEntr@l
centre	`sEnt@
century	`sEntS@ri:
ceramic	s@`rAmIk
cereal	`sI@ri:@l
cerebral	`sEr@br@l
ceremony	`sEr@m@ni:
certain	`s@:tn
certainly	`s@:tnli:
certificate	s@`tIfIk@t
certify	`s@:t@fa:I
cervix	`s@:vIks
CES	si: i: `Es
chafe	tSEIf
chain	tSEIn
chainsaw	`tSEIns@:
chair	tSE@
chairman	`tSE@m@n
chairperson	`tSE@p@:sn
chalk	tS@:k
challenge	`tSAl@ndZ
chamber	`tSEImb@
chamois	`SAmi:
champion	`tSAmpj@n
chance	tSAns, tSa:ns
change	tSEIndZ
channel	`tSAn@l
chant	tSAnt
chaos	`kEIOs
chap	tSAp
chapel	`tSAp@l
chapped	tSApt
chapter	`tSApt@
character	`kAr@kt@
characteristic	kAr@kt@`rIstIk
charade	S@`ra:d, S@`rEId
charcoal	`tSa:k@Ul
charge	tSa:dZ
charisma	k@`rIzm@
charity	`tSAr@ti:
charm	tSa:m
chart	tSa:t
charter	`tSa:t@
chase	tSEIs
chassis	`SAzi:
chat	tSAt
chatter	`tSAt@
chauffeur	`S@Uf@, S@U`f@:
chauvinism	`S@Uv@nIz@m
cheap	tSi:p
cheat	tSi:t
check	tSEk
checkout	`tSEka:Ut
check-up	`tSEk-V p
cheek	tSi:k
cheer	tSI@
cheerful	`tSI@fUl
cheese	tSi:z
chef	SEf
chemical	`kEmIk@l
chemist	`kEm@st
chemistry	`kEm@stri:
chemotherapy	kEm@U`TEr@pi:, ki:m@U-
cheque	tSEk
chequebook	`tSEkbUk
cherish	`tSErIS
cherub	`tSEr@b
chess	tSEs
chest	tSEst
chew	tSu:
chewing gum	`tSu:IN gV m
chic	Si:k
chick	tSIk
chicken	`tSIk@n
chickenpox	`tSIk@npOks
chief	tSi:f
child	tSa:Ild
childish	`tSa:IldIS
chill	tSIl
chilli	`tSIli:
chime	tISa:Im
chimney	`tSImni:
chin	tSIn
china	`tSa:In@
Chinese	`tSa:Ini:z
chip	tSIp
chipboard	`tSIpb@:d
chiropractor	`ka:Ir@prAkt@
chirp	tS@:p
chirpy	`tS@:pi:
	`tSIz@l
chlorine	`kl@:ri:n
chocolate	`tSOkl@t
choice	tS@:Is
choir	`kwa:I@
choke	tS@Uk
cholera	`kOl@r@
cholesterol	k@`lEst@rOl
chook	tSUk
choose	tSu:z
chop	tSOp
choppy	`tSOpi:
chopsticks	`tSOpstIks
chord	k@:d
chore	tS@:
choreographer	kOri:`Ogr@f@
chorus	`k@:r@s
chose	tS@Uz
chosen	`tS@Uz@n
christen	`krIs@n
Christianity	krIsti:`An@ti:
Christmas	`krIsm@s
Christmas bush	`krIsm@s bUS
chrome	kr@Um
chronic	`krOnIk
chronological	krOn@`lOdZIk@l
chubby	`tSV bi:
chuck	tSV k
chuckle	`tSV k@l
chunder	`tSV nd@
chunk	tSV Nk
church	tS@:tS
churn	tS@:n
chute	Su:t
chutney	`tSV tni:
cider	`sa:Id@
cigar	s@`ga:
cigarette	sIg@`rEt
cinema	`sIn@m@
circle	`s@:k@l
circuit	`s@:k@t
circulate	`s@:kj@lEIt
circulation	s@:kj@`lEIS@n
circumcise	`s@:k@msa:Iz
circumference	s@`kV mf@r@ns
circumstance	`sEk@mstAns
circus	`s@:k@s
citizen	`sIt@z@n
citrus	`sItr@s
city	`sIti:
civic	`sIvIk
civil	`sIv@l
civilian	s@`vIlj@n
civilisation	sIv@la:I`zEIS@n
civilised	`sIv@la:Izd
Cl.	kl@Us
claim	klEIm
clairvoyant	klE@`v@:I@nt
clam	klAm
clamber	`klAmb@
clammy	`klAmi:
clamour	`klAm@
clamp	klAmp
clan	klAn
clandestine	`klAnd@sta:In, klAn`dEst@n
clang	klAN
clanger	`klAN@
clap	klAp
clarify	`klAr@fa:I
clarity	`klAr@ti:
clash	klAS
clasp	klAsp, kla:sp
class	kla:s
classic	`klAsIk
classify	`klAs@fa:I
classroom	`kla:srUm
clatter	`klAt@
clause	kl@:z
claustrophobia	klOstr@`f@Ubi:@
claw	kl@:
clay	klEI
clean	kli:n
clear	klI@
clearance	`klI@r@ns
clearing	`klI@rIN
clearway	`klI@wEI
clench	klEntS
clergy	`kl@:dZi:
clerk	kla:k
clever	`klEv@
clich;aae	`kli:SEI
click	klIk
client	`kla:I@nt
cliff	klIf
climate	`kla:Im@t
climax	`kla:ImAks
climb	kla:Im
clinch	klIntS
cling	klIN
clinic	`klInIk
clip	klIp
cloak	kl@Uk
clock	klOk
clockwise	`klOkwa:Iz
clockwork	`klOkw@:k
clog	klOg
clone	kl@Un
close	kl@Uz
close-up	`kl@Us-V p
clot	klOt
cloth	klOT
clothe	kl@UD
clothes	kl@UDz
clothing	`kl@UDIN
cloud	kla:Ud
cloudy	`kla:Udi:
clout	kla:Ut
clover	`kl@Uv@
clown	kla:Un
club	klV b
clucky	`klV ki:
clue	klu:
clump	klV mp
clumsy	`klV mzi:
clung	klV N
cluster	`klV st@
clutch	klV tS
clutter	`klV t@
cm	`sEnt@mi:t@
Co	`kV mp@ni:
c/o	`kE@rOv
coach	k@UtS
coagulate	k@U`Agj@lEIt
coal	k@Ul
coalition	k@U@`lIS@n
coarse	k@:s
coast	k@Ust
coastline	`k@Ustla:In
coat	k@Ut
coathanger	`k@UthAN@
coating	`k@UtIN
coax	k@Uks
cobweb	`kObwEb
cocaine	k@U`kEIn
cock	kOk
cockatoo	kOk@`tu:
cockpit	`kOkpIt
cocktail	`kOktEIl
cock-up	`kOk-V p
cocky	`kOki:
coconut	`k@Uk@nV t
COD	si: @U `di:
code	k@Ud
codeine	`k@Udi:n
coerce	k@U`@:s
coffee	`kOfi:
coffin	`kOf@n
	kOg
coherent	k@U`hI@r@nt
cohesion	k@U`hi:Z@n
coil	k@:Il
coin	k@:In
coincide	k@U@n`sa:Id
coincidence	k@U`Ins@d@ns
coke	k@Uk
colander	`kV l@nd@, `kOl-
cold	k@Uld
cold-blooded	`k@Uld-blV d@d
coleslaw	`k@Ulsl@:
colic	`kOlIk
collaborate	k@`lAb@rEIt
collapse	k@`lAps
	`kOl@
collarbone	`kOl@b@Un
collateral	k@`lAt@r@l
colleague	`kOli:g
collect	k@`lEkt
collective	k@`lEktIv
collector	k@`lEkt@
college	`kOlIdZ
collide	k@`la:Id
cologne	k@`l@Un
colon	`k@Ul@n
colonel	`k@:n@l
colony	`kOl@ni:
colossal	k@`lOs@l
colour	`kV l@
column	`kOl@m
coma	`k@Um@
comb	k@Um
combat	`kOmbAt
combination	kOmb@`nEIS@n
combination lock	kOmb@`nEIS@n lOk
combine	k@m`ba:In
come	kV m
comedy	`kOm@di:
comet	`kOm@t
comfort	`kV mf@t
comfortable	`kV mft@b@l, `kV mf@t@b@l
comic	`kOmIk
comma	`kOm@
command	k@`mAnd, -`ma:nd
commando	k@`mAnd@U, -`ma:n-
commemorate	k@`mEm@rEIt
commence	k@`mEns
commend	k@`mEnd
comment	`kOmEnt
commentary	`kOm@ntri:
commerce	`kOm@:s
commercial	k@`m@:S@l
commiserate	k@`mIz@rEIt
commission	k@`mIS@n
commissioner	k@`mIS@n@
commit	k@`mIt
commitment	k@`mItm@nt
committee	k@`mIti:
commodity	k@`mOd@ti:
common	`kOm@n
Commonwealth	`kOm@nwElT
commotion	k@`m@US@n
communal	k@`mju:n@l, `kOmj@n@l
commune	`kOmju:n
communicate	k@`mju:n@kEIt
communication	k@`mju:n@kEIS@n
communism	`kOmj@nIz@m
community	k@`mju:n@ti:
commute	k@`mju:t
compact	`kOmpAkt
compact disc	kOmpAkt `dIsk
companion	k@m`pAnj@n
company	`kV mp@ni:
comparative	k@m`pAr@tIv
compare	k@m`pE@
comparison	k@m`pAr@s@n
compartment	k@m`pa:tm@nt
	`kV mp@s
compassion	k@m`pAS@n
compatible	k@m`pAt@b@l
compel	k@m`pEl
compelling	k@m`pElIN
compensate	`kOmp@nsEIt
compere	`kOmpE@
compete	k@m`pi:t
competent	`kOmp@t@nt
competition	kOmp@`tIS@n
competitive	k@m`pEt@tIv
compile	k@m`pa:Il
complacent	k@m`plEIs@nt
complain	k@m`plEIn
complaint	k@m`plEInt
complement	`kOmpl@m@nt
complete	k@m`pli:t
complex	`kOmplEks
complexion	k@m`plEkS@n
complicated	`kOmpl@kEIt@d
compliment	`kOmpl@m@nt
complimentary	kOmpl@`mEntri:
comply	k@m`pla:I
component	k@m`p@Un@nt
compose	k@m`p@Uz
compost	`kOmpOst
compound	`kOmpa:Und
comprehend	kOmpr@`hEnd
compress	k@m`prEs
comprise	k@m`pra:Iz
compromise	`kOmpr@ma:Iz
compulsion	k@m`pV lS@n
compulsory	k@m`pV ls@ri:
compute	k@m`pju:t
computer	k@m`pju:t@
comrade	`kOmrEId
con	kOn
concave	`kOnkEIv, kON`kEIv
conceal	k@n`si:l
concede	k@n`si:d
conceit	k@n`si:t
conceited	k@n`si:t@d
conceivable	k@n`si:v@b@l
conceive	k@n`si:v
concentrate	`kOns@ntrEIt
concept	`kOnsEpt
conception	k@n`sEpS@n
concern	k@n`s@:n
concerning	k@n`s@:nIN
concert	`kOns@t
concession	k@n`sES@n
conciliation	k@nsIli:`EIS@n
concise	k@n`sa:Is
conclude	k@N`klu:d
concrete	`kONkri:t
concur	k@N`k@:
concurrent	k@N`kV r@nt
concussion	k@N`kV S@n
condemn	k@n`dEm
condensation	kOnd@n`sEIS@n
condense	k@n`dEns
condescend	kOnd@`sEnd
condition	k@n`dIS@n
conditioned	k@n`dIS@nd
condom	`kOndOm
condone	k@n`d@Un
conduct	k@n`dV kt
cone	k@Un
confectionery	k@n`fEkS@nri:
confer	k@n`f@:
conference	kOnf@r@ns
confess	k@n`fEs
confidence	`kOnf@d@ns
confident	`kOnf@d@nt
confidential	kOnf@`dEnS@l
confine	k@n`fa:In
confirm	k@n`f@:m
confiscate	`kOnf@skEIt
conflict	`kOnflIkt
conform	k@n`f@:m
confront	k@n`frV nt
confuse	k@n`fju:z
congested	k@n`dZEst@d
congratulate	k@n`grAtS@lEIt
congregate	`kONgr@gEIt
congregation	kONgr@`gEIS@n
congress	`kONgrEs
conjunction	k@n`dZV NkS@n
conjunctivitis	k@ndZV Nkt@`va:It@s
conjure	`kV ndZ@
connect	k@`nEkt
conquer	`kONk@
conscience	`kOnS@ns
conscientious	kOnSi:`EnS@s
conscious	`kOnS@s
conscript	`kOnskrIpt
consecutive	k@n`sEkj@tIv
consent	k@n`sEnt
consequence	`kOns@kw@ns
conservation	kOns@`vEIS@n
conservative	k@n`s@:v@tIv
conserve	k@n`s@:v
consider	k@n`sId@
considerable	k@n`sIdr@b@l
considerate	k@n`sId@r@t
consideration	k@nsId@`rEIS@n
consist	k@n`sIst
consistency	k@n`sIst@nsi:
consistent	k@n`sIst@nt
consolation	kOns@`lEIS@n
console	k@n`s@Ul
consonant	`kOns@n@nt
conspicuous	k@n`spIkju:@s
conspiracy	k@n`spIr@si:
constable	`kV nst@b@l
constant	`kOnst@nt
constellation	kOnst@`lEIS@n
consternation	kOnst@`nEIS@n
constipation	kOnst@`pEIS@n
constituency	k@n`stItju:@nsi:
constitution	kOnst@`tju:S@n
constrict	k@n`strIkt
construct	k@n`strV kt
constructive	k@n`strV ktIv
consul	`kOns@l
consult	k@n`sV lt
consultant	k@n`sV lt@nt
consume	k@n`sju:m
consumer	k@n`sju:m@
contact	`kOntAkt
contagious	k@n`tEIdZ@s
contain	k@n`tEIn
container	k@n`tEIn@
contaminate	k@n`tAm@nEIt
contemplate	`kOnt@mplEIt
contemporary	k@n`tEmp@ri:, -pri:
contempt	k@n`tEmpt
contend	k@n`tEnd
content	`kOntEnt
contest	`kOntEst
context	`kOntEkst
continent	`kOnt@n@nt
continual	k@n`tInju:@l
continue	k@n`tInju:
continuous	k@n`tInju:@s
contour	`kOnt@:, -tU@
contraband	`kOntr@bAnd
contraception	kOntr@`sEpS@n
contraceptive	kOntr@`sEptIv
contract	`kOntrAkt
contradict	kOntr@`dIkt
contrary	`kOntr@ri:
contrast	`kOntra:st
contribute	k@n`trIbju:t
control	k@n`tr@Ul
controversy	`kOntr@v@:si:, k@n`trOv@si:
convalescence	kOnv@`lEs@ns
convene	k@n`vi:n
convenience	k@n`vi:nj@ns
convenient	k@n`vi:ni:@nt
convent	`kOnv@nt
convention	k@n`vEnS@n
conventional	k@n`vEnS@n@l
conversation	kOnv@`sEIS@n
converse	`kOnv@:s
convert	k@n`v@:t
convertible	k@n`v@:t@bl
convex	`kOnvEks
convey	k@n`vEI
convict	k@n`vIkt
conviction	k@n`vIkS@n
convince	k@n`vIns
convoy	`kOnv@:I
cook	kUk
cook book	`kUk bUk
cool	ku:l
coolabah	`ku:l@ba:
coop	ku:p
cooperate	k@U`Op@rEIt
coordinate	k@U`@:d@nEIt
cop	kOp
cope	k@Up
copper	`kOp@
copy	`kOpi:
copyright	`kOpi:|;ra:It
	`kOr@l
cord	k@:d
cordial	
corduroy	`k@:dZ@r@:I, `k@:d@r@:I
core	k@:
cork	k@:k
corkscrew	`k@:kskru:
corn	k@:n
corner	`k@:n@
cornflakes	`k@:nflEIks
corny	`k@:ni:
coronary	`kOr@nri:
coronation	kOr@`nEIS@n
coroner	`kOr@n@
corporal	`k@:p@r@l
corporation	k@:p@`rEIS@n
corps	k@:
corpse	k@:ps
correct	k@`rEkt
correspond	kOr@`spOnd
corridor	`kOr@d@:
corroboree	k@`rOb@ri:
corrode	k@`r@Ud
corrugated	`kOr@gEIt@d
corrupt	k@`rV pt
cortisone	`k@:t@z@Un
cosmetic	kOz`mEtIk
cosmopolitan	kOzm@`pOl@tn
cosmos	`kOzmOs
cossie	`kOzi:
cost	kOst
costume	`kOstju:m
cosy	`k@Uzi:
cot	kOt
cottage	`kOtIdZ
cotton	`kOt@n
couch	ka:UtS
cough	kOf
could	kUd
council	`ka:Uns@l
counsel	`ka:Uns@l
count	ka:Unt
counter	`ka:Unt@
counterfeit	`ka:Unt@f@t, -fi:t
country	`kV ntri:
coup	ku:
couple	`kV p@l
coupon	`ku:pOn
courage	`kV rIdZ
courier	`kUri:@
course	k@:s
court	k@:t
courteous	`k@:ti:@s
courtyard	`k@:tja:d
cousin	`kV z@n
cove	k@Uv
covenant	`kV v@n@nt
cover	`kV v@
covet	`kV v@t
cow	ka:U
coward	`ka:U@d
crab	krAb
crack	krAk
cracker	`krAk@
crackle	`krAk@l
crackling	`krAklIN
cradle	`krEId@l
craft	kra:ft
crafty	`kra:fti:
crag	krAg
cram	krAm
cramp	krAmp
cramped	krAmpt
crane	krEIn
crank	krANk
cranky	`krANki:
crash	krAS
crate	krEIt
crater	`krEIt@
crave	krEIv
crawl	kr@:l
crayfish	`krEIfIS
crayon	`krEIOn
craze	krEIz
crazy	`krEIzi:
creak	kri:k
cream	kri:m
crease	kri:s
create	kri:`EIt
creature	`kri:tS@
creche	krEIS, krES
credible	`krEd@bl
credit	`krEd@t
creek	kri:k
creep	kri:p
creeper	`kri:p@
cremate	kr@`mEIt
crematorium	krEm@`t@:ri:@m
crepe	krEIp
crest	krEst
crevice	`krEv@s
crew	kru:
crib	krIb
cricket	`krIk@t
crime	kra:Im
crimson	`krImz@n
cringe	krIndZ
crinkle	`krINk@l
cripple	`krIp@l
crisis	`kra:Is@s
crisp	krIsp
critic	`krItIk
critical	`krItIk@l
croak	kr@Uk
Croatian	kr@U`EIS@n
crockery	`krOk@ri:
crocodile	`krOk@da:Il
crook	krUk
crooked	`krUk@d
croon	kru:n
crop	krOp
cross	krOs
Cross	krOs
cross-examine	krOs-Eg`zAm@n
crossroads	`krOsr@Udz
crossword	`krOsw@:d
crouch	kra:UtS
croupier	`kru:pi:@
crow	kr@U
crowbar	`kr@Uba:
crowd	kra:Ud
crown	kra:Un
crucial	`kru:S@l
crucify	`kru:s@fa:I
crude	kru:d
cruel	`kru:@l
cruise	kru:z
crumb	krV m
crumble	`krV mb@l
crummy	`krV mi:
crumpet	`krV mp@t
crumple	`krV mp@l
crunch	krV ntS
crusade	kru:`sEId
crush	krV S
crust	krV st
crustacean	krV s`tEIS@n
crutch	krV tS
crux	krV ks
cry	kra:I
cryptic	`krIptIk
crystal	`krIst@l
cub	kV b
	kju:b
cubic	`kju:bIk
cubicle	`kju:bIk@l
cucumber	`kju:kV mb@
cuddle	`kV dl
cuddly	`kV dli:
cue	kju:
cuff	kV f
cul-de-sac	`kV l-d@-sAk
culinary	`kV l@nri:, -@n@ri:
culminate	`kV lm@nEIt
culprit	`kV lprIt
cult	kV lt
cultivate	`kV lt@vEIt
culture	`kV ltS@
cumbersome	`kV mb@s@m
cumquat	`kV mkwOt
cunning	`kV nIN
cunt	kV nt
cup	kV p
cupboard	`kV b@d
curb	k@:b
curdle	`k@:dl
cure	`kju:@, kjU@
curious	`kju:ri:@s
curl	k@:l
currant	`kV r@nt
currawong	`kV r@wON
currency	`kV r@nsi:
current	`kV r@nt
curriculum	k@`rIkj@l@m
curriculum vitae	
curry	`kV ri:
curse	k@:s
curt	k@:t
curtail	k@:`tEIl
curtain	`k@:t@n
curtsy	`k@:tsi:
curve	k@:v
cushion	`kUS@n
cushy	`kUSi:
custard	`kV st@d
custody	`kV st@di:
custom	`kV st@m
customary	`kV st@m@ri:, -t@mri:
customer	`kV st@m@
cut	kV t
cute	kju:t
cuticle	`kju:tIk@l
cutlery	`kV tl@ri:
cutlet	`kV tl@t
CV	si:`vi:
cycle	`sa:Ik@l
cyclone	`sa:Ikl@Un
cylinder	`sIl@nd@
cynic	`sInIk
cynical	`sInIkl
cyst	sIst
cystitis	sIs`ta:It@s
Czech	tSEk
D, d	di:
'd	
D	di:
d.	
dab	dAb
dad	dAd
dagger	`dAg@
daily	`dEIli:
dainty	`dEInti:
dairy	`dE@ri:
dais	`dEI@s
dam	dAm
damage	`dAmIdZ
damn	dAm
damned	dAmd
damnedest	`dAmd@st
damp	dAmp
dampen	`dAmp@n
damper	`dAmp@
dance	dAns, da:ns
dandruff	`dAndrV f
danger	`dEIndZ@
dangle	`dANg@l
dank	dANk
dapper	`dAp@
dappled	`dAp@ld
dare	dE@
daredevil	`dE@dEv@l
dark	da:k
darkroom	`da:kru:m
darling	`da:lIN
darn	da:n
dart	da:t
dash	dAS
dashboard	`dASb@:d
data	`da:t@, `dEIt@
database	`dEIt@bEIs, `da:t@-
date	dEIt
dated	`dEIt@d
daub	d@:b
daughter	`d@:t@
daughter-in-law	`d@:t@r-In-l@:
daunt	d@:nt
dawdle	`d@:d@l
dawn	d@:n
day	dEI
daybreak	`dEIbrEIk
day care centre	`dEI kE@ sEnt@
daydream	`dEIdri:m
daylight	`dEIla:It
daytime	`dEIta:Im
daze	dEIz
dazzle	`dAz@l
dead	dEd
deaden	`dEd@n
dead end	dEd `End
dead-end	`dE-End
dead heat	dEd `hi:t
dead letter	dEd `lEt@
deadline	`dEdla:In
deadlock	`dEdlOk
deadly	`dEdli:
deaf	dEf
deal	di:l
dealer	`di:l@
dealings	`di:lINz
dear	dI@
death	dET
debatable	d@`bEIt@b@l
debate	d@`bEIt
debit	`dEb@t
debris	`dEbri:, `dEIbri:, d@`bri:
debt	dEt
debug	di:`bV g
debut	`dEIbju:,  d@`bu:
Dec.	
decade	`dkEId
decadent	`dEk@d@nt
decaffeinated	di:`kAf@nEIt@d
decapitate	di:`kAp@tEIt
decathlon	d@`kATlOn, -l@n
decay	di:`kEI, d@-
deceased	dE`sIst
deceitful	d@`si:tfUl
deceive	d@`si:v
December	d@`sEmb@
decent	`di:s@nt
decentralise	di:`sEntr@la:Iz
deception	d@`sEpS@n
deceptive	d@`sEptIv
decibel	`dEs@bEl
decide	d@`sa:Id
decided	d@`sa:Id@d
deciduous	d@`sIdZu:@s
decimal	`dEs@m@l
decimate	`dEs@mEIt
decipher	d@`sa:If@
decision	d@`sIZ@n
deck	dEk
declare	d@`klE@
decline	d@`kla:In
decode	di:`k@Ud
decompose	di:k@m`p@Uz
decongestant	di:k@n`dZEst@nt
decor	`dEIk@:
decorate	`dEk@rEIt
decoration	dEk@`rEIS@n
decorum	d@`k@:r@m
decoy	`di:k@:I
decrease	d@`krIs
decree	d@`kri:
decrepit	d@`krEp@t
decry	d@`kra:I
dedicate	`dEd@kEIt
deduce	d@`dju:s
deduct	d@`dV kt
deduction	d@`dV kS@n
deed	di:d
deep	di:p
deep freeze	di:p `fri:z
deer	dI@
deface	d@`fEIs
de facto	di: `fAkt@U, d@-, dEI-
defamation	dEf@`mEIS@n
default	d@`fOlt, d@`f@:lt
defeat	d@`fi:t
defecate	`dEf@kEIt
defect	`di:fEkt
defence	d@`fEns
defend	d@`fEnd
defendant	d@`fEnd@nt
defensive	d@`fEnsIv
defer	d@`f@:
defiant	d@`fa:I@nt
deficient	d@`fIS@nt
deficit	`dEf@s@t
define	d@`fa:In
definite	`dEf@n@t
definitive	d@`fIn@tIv
deflate	d@`flEIt
deflation	d@`flEIS@n
deflect	d@`flEkt
defoliant	d@`f@Uli:@nt
defoliate	d@`f@Uli:EIt
deform	d@`f@:m
defraud	d@`fr@:d
defrost	di:`frOst, d@-
deft	dEft
defunct	d@`fV Nkt
defuse	di:`fju:z
defy	d@`fa:I
degenerate	d@`dZEn@r@t
degradation	dEgr@`dEIS@n
degrade	d@`grEId
degree	d@`gri:
dehydrate	`di:ha:IdrEIt, di:ha:I`drEIt
deign	dEIn
deity	`dEI@ti:
dejected	d@`dZEkt@d
delay	d@`lEI
delectable	d@`lEkt@b@l
delegate	`dEl@g@t
delegation	dEl@`gEIS@n
delete	d@`li:t
deli	`dEli:
deliberate	d@`lIb@r@t
delicacy	`dEl@k@si:
delicate	`dEl@k@t
delicatessen	dEl@k@`tEs@n
delicious	d@`lIS@s
delight	d@`la:It
delinquent	d@`lINkw@nt
delirious	d@`lIri:@s
deliver	d@`lIv@
delta	`dElt@
delude	d@`lu:d
deluge	`dElju:dZ
deluxe	d@`lV ks
delve	dElv
demand	d@`mAnd, d@`ma:nd
demanding	d@`mAndIN, d@`ma:ndIN
demean	d@`mi:n
demeanour	d@`mi:n@
demented	d@`mEnt@d
dementia	d@`mEnS@
demerit	di:`mEr@t
demise	d@`ma:Iz
demister	di:`mIst@
demo	`dEm@U
democracy	d@`mOkr@si:
democrat	`dEm@krAt
Democrats	`dEm@krAts
demolish	d@`mOlIS
demon	`di:m@n
demonstrate	`dEm@nstrEIt
demonstration	dEm@n`strEIS@n
demonstrative	d@`mOnstr@tIv
demoralise	d@`mOr@la:Iz
demote	di:`m@Ut
demure	d@`mjU@
den	dEn
denigrate	`dEn@grEIt
denim	`dEn@m
denomination	d@`nOm@nEIS@n
denominator	d@`nOm@nEIt@
denounce	d@`na:Uns
dense	dEns
dent	dEnt
dental	`dEnt@l
dental floss	`dEnt@l flOs
dentist	`dEnt@st
denture	`dEntS@
deny	d@`na:I
deodorant	di:`@Ud@r@nt
depart	d@`pa:t
departed	d@`pa:t@d
department	d@`pa:tm@nt
depend	d@`pEnd
dependant	d@`pEnd@nt
dependent	d@`pEnd@nt
depict	d@`pIkt
deplete	d@`pli:t
deplore	d@`pl@:
deport	d@`p@:t
deportment	d@`p@:tm@nt
depose	d@`p@Uz
deposit	d@`pOz@t
depository	d@`pOz@tri:
depot	`dEp@U
depreciate	d@`pri:Si:EIt
depress	d@`prEs
depression	d@`prES@n
deprive	d@`pra:Iv
deprived	d@`pra:Ivd
dept	d@`pa:tm@nt
depth	dEpT
deputation	dEpju:`tEIS@n
deputy	`dEpj@ti:
deranged	d@`rEIndZd
derelict	`dEr@lIkt
deride	d@`ra:Id
derivative	d@`rIv@tIv
derive	d@`ra:Iv
dermatitis	d@:m@`ta:It@s
derogatory	d@`rOg@tri:, -@t@ri:
descend	d@`sEnd
descendant	d@`sEnd@nt
descended	d@`sEnd@d
descent	d@`sEnt
describe	d@`skra:Ib
description	d@`skrIpS@n
desecrate	`dEs@krEIt
desert	`dEz@t
deserve	d@`z@:v
design	d@`za:In
designate	`dEzIgnEIt
desirable	d@`za:I@r@bl
desire	d@`za:I@
desk	dEsk
desktop	`dEsktOp
desolate	`dEs@l@t
despair	d@`spE@
desperate	`dEspr@t, -p@r@t
despicable	d@`spIk@b@l
despise	d@`spa:Iz
despite	d@`spa:It
despondent	d@`spOnd@nt
despot	`dEspOt
dessert	d@`z@:t
destination	dEst@`nEIS@n
destined	`dEst@nd
destiny	`dEst@ni:
destitute	`dEst@tju:t, -tSu:t
destroy	d@`str@:I
detach	d@`tAtS
detached	d@`tAtSt
detachment	d@`tAtSm@nt
detail	`di:tEIl
detain	d@`tEIn
detect	d@`tEkt
detective	d@`tEktIv
detention	d@`tEnS@n
deter	d@`t@:
detergent	d@`t@:dZ@nt
deteriorate	d@`tI@ri:@rEIt
determination	d@t@:m@`nEIS@n
determine	d@`t@:m@n
determined	d@`t@:m@nd
determiner	d@`t@:m@n@
deterrent	d@`tEr@nt, -`t@:r-
detest	d@`tEst
detonate	`dEt@nEIt
detour	`di:tU@, -t@:
detract	d@`trAkt
detrimental	dEtr@`mEntl
devalue	di:`vAlju:
devastate	`dEv@stEIt
devastating	`dEv@stEItIN
develop	d@`vEl@p
developer	d@`vEl@p@
development	d@`vEl@pm@nt
deviant	`di:vi:@nt
deviate	`di:vi:EIt
device	d@`va:Is
devil	`dEv@l
devious	`di:vi:@s
devise	d@`va:Iz
devoid	d@`v@:Id
devote	d@`v@Ut
devoted	d@`v@Ut@d
devotee	dEv@`ti:
devour	d@`va:U@
devout	d@`va:Ut
dew	dju:
dexterity	dEks`tEr@ti:
diabetes	da:I@`bi:ti:z
diabolic	da:I@`bOlIk
diagnose	
diagonal	da:I`Ag@n@l
diagram	`da:I@grAm
dial	`da:I@l
dialect	`da:I@lEkt
dialogue	`da:I@lOg
diameter	da:I`Am@t@
diametrically	da:I@`mEtrIkli:
diamond	`da:I@m@nd, `da:Im@nd
diaphragm	`da:I@frAm
diarrhoea	da:I@`ri:@
diary	`da:I@ri:
dice	da:Is
dicey	`da:Isi:
dick	dIk
dickhead	`dIkhEd
dictate	dIk`tEIt, `dIktEIt
dictator	dIk`tEIt@, `dIktEIt@
diction	`dIkS@n
dictionary	`dIkS@nri:, `dIkS@n@ri:
did	dId
didgeridoo	dIdZ@ri:`du:
die	da:I
diesel	`di:z@l
diet	`da:I@t
differ	`dIf@
difference	`dIfr@ns
different	`dIfr@nt
differentiate	dIf@`rEnSi:EIt
difficult	`dIf@k@lt
diffident	`dIf@d@nt
diffuse	d@`fju:z
dig	dIg
digest	d@`dZEst, da:I-
digger	`dIg@
diggings	`dIgINz
digit	`dIdZ@t
digital	`dIdZ@t@l
dignity	`dIgn@ti:
digress	da:I`grEs
dilapidated	d@`lAp@dEIt@d
dilate	da:I`lEIt
dilemma	d@`lEm@
diligent	`dIl@dZ@nt
dill	dIl
dilute	da:I`lu:t
dim	dIm
dimension	d@`mEnS@n
diminish	d@`mInIS
dimple	`dImpl
din	dIn
dine	da:In
diner	`da:In@
ding	dIN
dinghy	`dINgi:
dingo	`dINg@U
dingy	`dIndZi:
dining	`da:InIN
dining car	`da:InIN ka:
dining room	`da:InIN ru:m
dining table	`da:InIN tEIbl
dinki-di	dINki:-`da:I
dinkum	`dINk@m
dinner	`dIn@
dinosaur	`da:In@s@:
dip	dIp
diphtheria	dIf`TI@ri:@
diphthong	`dIfTON
diploma	d@`pl@Um@
diplomacy	d@`pl@Um@si:
diplomat	`dIpl@mAt
dire	da:I@
direct	d@`rEkt
direction	d@`rEkS@n
directive	d@`rEktIv
directly	d@`rEktli:
director	d@`rEkt@
directory	d@`rEktri:
dirt	d@:t
dirty	`d@:ti:
disability	dIs@`bIl@ti:
disable	dIs`EIbl
disadvantage	dIs@d`vAntIdZ
disadvantaged	dIs@d`vAntIdZd
disagree	dIs@`gri:
disagreeable	dIs@`gri:@bl
disallow	dIs@`la:U
disappear	dIs@`pI@
disappoint	dIs@`p@:Int
disapprove	dIs@`pru:v
disarm	dIs`a:m
disarray	dIs@`rEI
disaster	dI`za:st@
disband	dIs`bAnd
disbelieve	dIsb@`li:v
disc	dIsk
discard	dIs`ka:d
discern	dI`s@:n
discerning	dI`s@:nIN
discharge	dIs`tSa:dZ
disciple	d@`sa:Ipl
disciplinarian	dIs@pl@`nE@ri:@n
discipline	`dIs@pl@n
disc jockey	`dIsk dZOki:
disclose	dIs`kl@Uz
disco	`dIsk@U
discolour	dIs`kV l@
discomfort	dIs`kV mf@t
disconcert	dIsk@n`s@:t
disconnect	dIsk@`nEkt
discontent	dIsk@n`tEnt
discontinue	dIsk@n`tInju:
discord	`dIsk@:d
discount	`dIska:Unt
discourage	dI`skV rIdZ
discourse	`dIsk@:s
discourteous	dI`sk@:ti:@s
discover	dI`skV v@
discredit	dI`skrEd@t
discreet	dI`skri:t
discrepancy	dI`skrEp@nsi:
discrete	dI`skri:t
discretion	dI`skrES@n
discriminate	dI`skrIm@nEIt
disdain	dIs`dEIn
disease	d@`zi:z
disfavour	dIs`fEIv@
disfigure	dIs`fIg@
disgrace	d@s`grEIs
disgruntled	dIs`grV ntld
disguise	dIs`ga:Iz
disgust	d@s`gV st
dish	dIS
disheartened	dIs`ha:t@nd
dishevelled	dI`SEv@ld
dishonest	dIs`On@st
dishonour	dIs`On@
dishwasher	`dISwOS@
disillusioned	dIsI`lu:Z@nd
disinclined	dIsIn`kla:Ind
disinfect	dIsIn`fEkt
disinfectant	dIsIn`fEkt@nt
disintegrate	dIs`Int@grEIt
disinterested	dIs`Intr@st@d
disjointed	dIs`dZ@:Int@d
disk	dIsk
diskette	dIs`kEt
dislike	dIs`la:Ik
dislocate	`dIsl@kEIt
dislodge	dIs`lOdZ
disloyal	dIs`l@:I@l
dismal	`dIzm@l
dismantle	dIs`mAntl
dismay	dIs`mEI
dismiss	dIs`mIs
dismount	dIs`ma:Unt
disobey	dIs@`bEI
disorder	dIs`@:d@
disorganised	dIs`@:g@na:Izd
disorientated	dIs`Ori:@n;tEIt@d
dispatch	dIs`pAtS
dispel	dI`spEl
dispensable	dI`spEns@bl
dispensation	dIspEn`sEIS@n
dispense	dI`spEns
disperse	dI`sp@:s
displace	dI`splEIs
display	dI`splEI
displease	dI`spli:z
disposable	dI`sp@Uz@bl
disposable income	dI;sp@Uz@bl `INkV m
disposal	dI`sp@Uz@l
dispose	dI`sp@Uz
disposed	dI`sp@Uzd
disposition	dIsp@`zISn
dispossess	dIsp@`zEs
disproportion	dIspr@`p@:Sn
disprove	dI`spru:v
dispute	
disqualify	dI`skwOl@fa:I
disregard	dIsr@`ga:d
disrepair	dIsr@`pE@
disreputable	dIs`rEpj@t@bl
disrepute	dIsr@`pju:t
disrespect	dIsr@`spEkt
disrupt	dIs`rV pt
dissatisfied	dI`sAtIsfa:Id
dissect	dI`sEkt
dissension	dI`sEnS@n
dissent	dI`sEnt
dissertation	dIs@`tEIS@n
dissident	`dIs@d@nt
dissimilar	dI`sIm@l@
dissipate	`dIs@pEIt
dissociate	dI`s@Usi:EIt
dissolution	dIs@`lu:S@n
dissolve	d@`zOlv
dissuade	dI`swEId
distance	`dIst@ns
distant	`dIst@nt
distasteful	dI`stEIstfUl
distend	dI`stEnd
distil	dI`stIl
distillate	`dIst@l@t
distinct	d@`stINkt
distinction	d@`stINkS@n
distinctive	d@`stINktIv
distinguish	d@`stINgwIS
distort	d@`st@:t
distract	d@`strAkt
distraught	dI`str@:t
distress	d@`strEs
distribute	d@`strIbju:t
distribution	dIstr@`bju:S@n
district	`dIstrIkt
distrust	d@`strV st
disturb	d@`st@:b
disturbance	d@`st@:b@ns
disturbed	d@`st@:bd
disuse	dIs`ju:s
ditch	dItS
dither	`dID@
ditto	`dIt@U
divan	d@`vAn
dive	da:Iv
diver	`da:Iv@
diverge	da:I`v@:dZ
diverse	da:I`v@:s
diversify	d@`v@:s@fa:I
diversion	d@`v@:Z@n
divide	d@`va:Id
dividend	`dIv@dEnd
divination	dIv@`nEIS@n
divine	d@`va:In
divinity	d@`vIn@ti:
division	d@`vIZ@n
divorcee	d@v@:`si:
divulge	d@`vV ldZ
dizzy	`dIzi:
do	du:
dob	dOb
docile	`d@Usa:Il
dock	dOk
docket	`dOk@t
dockyard	`dOkja:d
doctor	`dOkt@
doctrine	`dOktr@n
document	`dOkj@m@nt
documentary	dOkj@`mEntri:
dodge	dOdZ
dodgy	`dOdZi:
doe	d@U
does	dV z
dog	dOg
dog-ear	`dOg-I@
dogged	`dOg@d
dogleg	`dOglEg
dogma	`dOgm@
dogmatic	dOg`mAtIk
doily	`d@:Ili:
doing	`du:IN
doldrums	`dOldr@mz
dole	d@Ul
doleful	`d@UlfUl
doll	dOl
dollar	`dOl@
dollop	`dOl@p
domain	d@`mEIn
dome	d@Um
domestic	d@`mEstIk
domesticate	d@`mEstIkEIt
dominate	`dOm@nEIt
domineering	dOm@`nI@rIN
donate	d@U`nEIt
done	dV n
donkey	`dONki:
donor	`d@Un@
don't	d@Unt
doodle	`du:dl
doom	du:m
doomsday	`du:mzdEI
doona	`du:n@
door	d@:
dope	d@Up
dopey	`d@Upi:
dork	d@:k
dorm	d@:m
dormant	`d@:m@nt
dormitory	`d@:m@tri:
dose	d@Us
dossier	`dOsi:@
dot	dOt
dote	d@Ut
dotty	`dOti:
double	`dV bl
double bass	dV bl `bEIs
doublecross	dV bl`krOs
doubt	da:Ut
doubtful	`da:UtfUl
dough	d@U
dour	dU@, da:U@
douse	da:Us
dove	dV v
dowdy	`da:Udi:
down	da:Un
downcast	`da:Unka:st
downfall	`da:Unf@:l
downgrade	da:Un`grEId, `da:UngrEId
downhearted	da:Un`ha:t@d
downhill	da:Un`hIl
down-market	da:Un-`ma:k@t
down payment	da:Un `pEIm@nt
downplay	da:Un`plEI
downpour	`da:Unp@:
downstream	da:Un`stri:m
down-to-earth	da:Un-tu:-`@:T
downtrodden	da:Un`trOdn
downturn	`da:Unt@:n
downward	`da:Unw@d
downwards	`da:Unw@dz
downwind	da:Un`wInd
downy	`da:Uni:
dowry	`da:Uri:
doz.	`dV z@n
doze	d@Uz
dozen	`dV z@n
Dr	`dOkt@
drab	drAb
draft	dra:ft
drag	drAg
dragon	`drAg@n
dragonfly	`drAg@nfla:I
drain	drEIn
drake	drEIk
drama	`dra:m@
dramatic	dr@`mAtIk
dramatise	`drAm@ta:Iz
drank	drANk
drape	drEIp
drastic	`drAstIk
draught	dra:ft
drawback	`dr@:bAk
drawcard	`dr@:ka:d
	dr@:
	`dr@:IN-pIn
drawl	dr@:l
drawn	dr@:n
dread	drEd
dreadful	`drEdfUl
dream	dri:m
Dreaming	`dri:mIN
dreamt	drEmt
dreary	`drI@ri:
drench	drEntS
dress	drEs
dresser	`drEs@
dressing	`drEsIN
dressing-gown	`drEsIN-ga:Un
dressing-table	`drEsIN-tEIb@l
dressmaker	`drEsmEIk@
drew	dru:
dribble	`drIb@l
dried	dra:Id
drier	`dra:I@
drift	drIft
drill	drIl
drink	drINk
drink-driving	drINk-`dra:IvIN
drip	drIp
drip-dry	`drIp-dra:I
dripping	`drIpIN
drive	dra:Iv
drive-in	`dra:Iv-In
driver's licence	`dra:Iv@z la:Is@ns
driveway	`dra:IvwEI
driving test	`dra:IvIN tEst
drizzle	`drIz@l
drone	dr@Un
drongo	`drONg@U
droop	dru:p
drop	drOp
droplet	`drOpl@t
drop-out	`drOp-a:Ut
dropper	`drOp@
droppings	`drOpINz
drought	dra:Ut
drove	dr@Uv
drown	dra:Un
drowsy	`dra:Uzi:
drug	drV g
drum	drV m
drumstick	`drV mstIk
drunk	drV Nk
dry	dra:I
dry-clean	dra:I-`kli:n
dual	`dju:@l
dub	dV b
dubious	`dju:bi:@s
duck	dV k
due	dju:
duel	`dju:@l
duet	dju:`Et
dug	dV g
dugout	`dV ga:Ut
dull	
duly	`dju:li:
dumb	dV m
dummy	`dV mi:
dump	dV mp
dumpling	`dV mplIN
dumpy	`dV mpi:
dune	dju:n
dung	dV N
dunk	dV Nk
dunny	`dV ni:
duo	`dju:@U
duodenum	dju:@`di:n@m
dupe	dju:p
duplex	`dju:plEks
duplicate	`dju:pl@kEIt
durable	`dju:r@b@l
duration	dju:`rEIS@n
during	`dju:rIN
dusk	dV sk
dust	dV st
dustpan	`dV stpAn
Dutch	dV tS
duty	`dju:ti:
duty-free	dju:ti:-`fri:
duvet	`du:vEI
dwarf	dw@:f
dwell	dwEl
dwindle	`dwIndl
dye	da:I
dying	`da:IN
dynamic	da:I`nAmIk
dynamics	da:I`nAmIks
dynamite	`da:In@ma:It
dysentery	`dIs@ntri:
dyslexia	dIs`lEksi:@
E, e	i:
E	i:
each	i:tS
eager	`i:g@
ear	I@
eardrum	`I@drV m
early	`@:li:
earn	@:n
earnest	`@:n@st
earphone	`I@f@Un
earring	`I@rIN
earth	@:T
earthenware	`@:D@nwE@
earthquake	`@:TkwEIk
ease	i:z
easel	`i:z@l
east	i:st
Easter	`i:st@
eastward	`i:stw@d
easy	`i:zi:
eat	i:t
eaves	i:vz
eavesdrop	`i:vzdrOp
EB	i: `bi:
ebb	Eb
eccentric	Ek`sEntrIk
ECG	i: si:`dZi:
	@`kIdn@
echo	`Ek@U
eclipse	@`klIps, i:-
ecology	@`kOl@dZi:
economics	Ek@`nOmIks, i:k@-
economy	@`kOn@mi:
eczema	`Eks@m@
edge	EdZ
edible	`Ed@b@l
edit	`Ed@t
edition	@`dIS@n
editorial	Ed@`t@:ri:@l
education	EdZ@`kEIS@n
eerie	`I@ri:
effect	@`fEkt
effective	@`fEktIv
effeminate	@`fEm@n@t
effervescent	Ef@`vEs@nt
efficient	@`fISnt
effort	`Ef@t
EFTPOS	`EftpOs
e.g.	i: `dZi:
egg	Eg
ego	`i:g@U
eiderdown	`a:Id@da:Un
eight	EIt
eighteen	EI`ti:n
eighteenth	EI`ti:nT
eighth	EItT
eighty	`EIti:
either	`a:ID@, `i:D@
eject	@`dZEkt, i:-
elaborate	@`lAb@r@t
elapse	@`lAps, i:-
elastic	@`lAstIk, i:-
elated	@`lEIt@d, i:-
elbow	`Elb@U
elder	`Eld@
elderly	`Eld@li:
eldest	`Eld@st
elect	@`lEkt, i:-
election	@`lEkS@n, i:-
elective	@`lEktIv, i:-
electorate	@`lEkt@r@t, -tr@t, i:-
electrician	@lEk`trIS@n, ElEk-, i:lEk-
electricity	@lEk`trIs@ti:, `ElEk-, `i:lEk-
electrocute	@`lEktr@kju:t, i:-
electronic	El@k`trOnIk, @lEk`trOnIk, i:-
elegant	`El@g@nt
element	`El@m@nt
elementary	El@`mEntri:
elevate	`El@vEIt
elevator	`El@vEIt@
eleven	@`lEv@n
eleventh	@`lEv@nT
eligible	`El@dZ@b@l
eliminate	@`lIm@nEIt, i:-
elite	@`li:t, EI-
ellipse	@`lIps
eloquent	`El@kw@nt
else	Els
elsewhere	`ElswE@
elusive	@`lu:sIv
e-mail	`i:-mEIl
embargo	Em`ba:g@U
embark	Em`ba:k
embarrass	Em`bAr@s
embassy	`Emb@si:
embezzle	Em`bEz@l
emblem	`Embl@m
embrace	Em`brEIs
embroider	Em`br@:Ud@
embryo	`Embri:@U
emerald	`Emr@ld, `Em@r@ld
emerge	@`m@:dZ, i:-
emergency	@`m@:dZ@nsi:, i:-
emigrant	`Em@gr@nt
emigrate	`Em@grEIt
eminent	`Em@n@nt
emotion	@`m@US@n
emphasis	`Emf@s@s
empire	`Empa:I@
employ	Em`pl@:I
empty	`Emti:
emu	`i:mju:
enable	En`EIb@l, @n-
enamel	@`nAm@l
enclose	En`kl@Uz, @n-
encode	En`k@Ud
encore	`Onk@:, `ONk@:
encounter	En`ka:Unt@, @n-
encourage	En`kV rIdZ, @n-
encyclopedia	Ensa:Ikl@`pi:di:@, @n-
end	End
endanger	En`dEIndZ@, @n-
endeavour	En`dEv@, @n-
endorse	En`d@:s, @n-
endure	En`djU@
enemy	`En@mi:
energy	`En@dZi:
engage	En`gEIdZ, @n-
engagement	En`gEIdZm@nt
engine	`EndZ@n
engineer	EndZ@`nI@
English	`INglIS
engrave	En`grEIv, @n-
enjoy	En`dZ@:I, @n-
enlarge	En`la:dZ, @n-
enlist	En`lIst
enormous	@`n@:m@s, i:-
enough	@`nV f, i:-
enquiry	In`kwa:Iri:, @n-, En-
enrage	En`rEIdZ, @n-
enrich	En`rItS, @n-
enrol	En`r@Ul, @n-
ensuite	`Onswi:t
ensure	En`S@:, @n-
entangled	En`tANg@ld, @n-
enter	`Ent@
enterprise	`Ent@pra:Iz
enterprise bargaining	Ent@pra:Iz `ba:g@nIN
entertain	Ent@`tEIn
enthusiasm	En`Tu:zi:Az@m
entice	En`ta:Is, @n-
entire	En`ta:I@, @n-
entitle	En`ta:Itl, @n-
entrance	`Entr@ns
entrant	`Entr@nt
entreat	En`tri:t, @n-
entree	`OntrEI
entrepreneur	Ontr@pr@`n@:
entry	`Entri:
envelope	`Env@l@Up, `On-
environment	En`va:Ir@nm@nt, @n-
envy	`Envi:
epic	`EpIk
epidemic	Ep@`dEmIk
epilepsy	`Ep@lEpsi:
episode	`Ep@s@Ud
epitome	@`pIt@mi:
epoch	`i:pOk, `EpOk
equal	`i:kw@l
equator	@`kwEIt@, i:-
equip	@`kwIp, i:-
equipment	@`kwIpm@nt, i:-
equivalent	@`kwIv@l@nt, i:-
era	`I@r@
eradicate	@`rAd@kEIt, i:-
erase	@`rEIz, i:-
erect	@`rEkt
erode	@`r@Ud, i:-
erotic	@`rOtIk
err	@:
errand	`Er@nd
erratic	@`rAtIk
error	`Er@
erupt	@`rV pt, i:-
escalator	`Esk@lEIt@
escapade	`Esk@pEId
escape	@s`kEIp
escort	@s`k@:t
esky	`Eski:
ESL	i: Es `El
especially	@s`pES@li:
espionage	`Espi:@na:Z, -na:dZ
essay	`EsEI
essence	`Es@ns
essential	@`sEnS@l
establish	@s`tAblIS
establishment	@s`tAblISm@nt
estate	@`stEIt
estate agent	@`stEIt EIdZ@nt, `Es-
esteem	@s`ti:m
estimate	`Est@mEIt
estranged	@`strEIndZd
etc.	Et `sEtr@
etch	EtS
etching	`EtSIN
eternal	@`t@:n@l, i:-
ethics	`ETIks
ethnic	`ETnIk
etiquette	`EtIk@t
	
euthanasia	ju:T@`nEIZ@
evacuate	@`vAkju:EIt
evade	@`vEId
evaluate	@`vAlju:EIt, i:-
evaporate	@`vAp@rEIt, i:-
eve	i:v
even	`i:v@n
evening	`i:vnIN
evening class	`i:vnIN kla:s
evening dress	`i:vnIN drEs
event	@`vEnt
eventually	@`vEntS@li:
ever	`Ev@
evergreen	`Ev@gri:n
every	`Evri:
everybody	`Evri:bOdi:
everyday	`Evri:dEI
everyone	`Evri:wV n
everything	`Evri:TIN
everywhere	`Evri:wE@
evict	@`vIkt
evidence	`Ev@d@ns
evident	`Ev@d@nt
evil	`i:v@l
evolution	Ev@`lu:S@n, i:v@-
ex-	Eks-
exact	@g`zAkt, Eg-
exactly	@g`zAktli:, Eg-
exaggerate	@g`zAdZ@rEIt, Eg-
exam	@g`zAm, Eg-
examination	@gzAm@`nEIS@n, Eg-
examine	@g`zAm@n, Eg-
example	@g`zAmp@l, Eg-
exasperate	@g`zAsp@rEIt, Eg-
excavate	`Eksk@vEIt
exceed	@k`si:d, Ek-
excel	@k`sEl, Ek-
excellent	`Eks@l@nt
except	@k`sEpt, Ek-
exception	@k`sEpS@n, Ek-
exceptional	@k`sEpS@n@l, Ek-
excess	`EksEs
exchange	@ks`tSEIndZ, Ek-
excite	@k`sa:It, Ek-
excited	@k`sa:It@d, Ek-
exciting	@k`sa:ItIN, Ek-
exclaim	@ks`klEIm, Eks-
exclamation	Ekskl@`mEIS@n
exclude	@ks`klu:d, Eks-
exclusive	@ks`klu:sIv, Eks-
excrete	@ks`kri:t, Eks-
excruciating	@ks`kru:Si:EItIN, Eks-
excursion	@k`sk@:S@n, Ek-
excuse	@k`skju:s
execute	`Eks@kju:t
executive	@g`zEkj@tIv, Eg-
executor	@g`sEkju:t@, Eg-
exempt	@g`zEmpt, Eg-
exercise	`Eks@sa:Iz
exert	@g`z@:t, Eg-
exhale	Eks`hEIl
exhaust	@g`z@:st, Eg-
exhaustive	@g`z@:stIv, Eg-
exhibit	@g`zIb@t, Eg-
exile	`Egza:Il, `Eksa:Il
exist	@g`zIst, Eg-, Ig-
exit	`Egz@t
exodus	`Eks@d@s
exotic	@g`zOtIk, Eg-
expand	@k`spAnd, Ek-
expanse	@k`spAns, Ek-
expect	@k`spEkt, Ek-
expedition	Eksp@`dIS@n
expel	@k`spEl, Ek-
expend	@k`spEnd, Ek-
expenditure	Ek`spEnd@tS@, Ek-
expense	@k`spEns, Ek-
expensive	@k`spEnsIv, Ek-
experience	@k`spI@ri:Ens, Ek-
experiment	@k`spEr@m@nt, Ek-
expert	`Eksp@:t
expire	@k`spa:I@, Ek-
explain	@k`splEIn, Ek-
expletive	@k`spli:tIv, Ek-
explode	@k`spl@Ud, Ek-
exploit	@k`spl@:It
explore	@k`spl@:, Ek-
explosion	@k`spl@UZ@n, Ek-
explosive	Ek`spl@UsIv
export	@k`sp@:t, Ek-
expose	@k`sp@Uz, Ek-
exposure	@k`sp@UZ@, Ek-
express	@k`sprEs, Ek-
expression	@k`sprES@n, Ek-
expressway	Ek`sprEswEI
expulsion	@k`spV lS@n, Ek-
exquisite	`Ekskw@z@t, @k`skwIz@t
extend	@k`stEnd, Ek-
extension	@k`stEnS@n, Ek-
extensive	@k`stEnsIv, Ek-
extent	@k`stEnt, Ek-
exterior	@k`stI@ri:@, Ek-
exterminate	@k`st@:m@nEIt, Ek-
external	@k`st@:n@l, Ek-
extinct	@k`stINkt, Ek-
extinguish	@k`stINgwIS, Ek-
extortion	@k`st@:S@n, Ek-
extra	`Ekstr@
extract	@k`strAkt
extraordinary	@k`str@:d@nri:, Ek-
extravagant	@k`strAv@g@nt, Ek-
extreme	@k`stri:m, Ek-
extremism	@k`stri:mIz@m, Ek-
eye	a:I
eyebrow	`a:Ibra:U
eyelash	`a:IlAS
eyelid	`a:IlId
eyesight	`a:Isa:It
eyesore	`a:Is@:
eyewitness	`a:IwItn@s
F, f	Ef
F	Ef
fable	
fabric	`fAbrIk
fabricate	`fAbr@kEIt
fabulous	`fAbju:l@s
facade	f@`sa:d
face	fEIs
faceless	`fEIsl@s
facelift	`fEIslIft
facet	`fAs@t
facilitate	f@`sIl@tEIt
facility	f@`sIl@ti:
facsimile	fAk`sIm@li:
fact	fAkt
faction	`fAkS@n
factor	`fAkt@
factory	`fAktri:
factual	`fAktSu:@l
faculty	`fAk@lti:
fad	fAd
fade	fEId
faeces	`fi:si:z
fag	fAg
Fahrenheit	`fAr@nha:It
fail	fEIl
failing	`fEIlIN
failure	`fEIlj@
faint	fEInt
fair	fE@
fairly	`fE@li:
fairway	`fE@wEI
fairy	`fE@ri:
fairy bread	`fE@ri: brEd
fairy floss	`fE@ri: flOs
fairytale	`fE@ri:tEIl
faith	fEIT
faithful	`fEITf@l
fake	fEIk
fall	f@:l
fallacy	`fAl@si:
fallible	`fAl@b@l
fallout	`f@:la:Ut
false	fOls, f@:ls
falter	`f@:lt@
fame	fEIm
familiar	f@`mIlj@
family	`fAm@li:, `fAmli:
family allowance	fAmli: @`la:U@ns
family allowance supplement	
family law	fAmli: `l@:
family planning	fAmli: `plAnIN
family room	fAmli: `ru:m
famine	`fAm@n
famished	`fAmISt
famous	`fEIm@s
fan	fAn
fanatic	f@`nAtIk
fanbelt	`fAnbElt
fanciful	`fAns@f@l
fancy	`fAnsi:
fang	fAN
fantastic	fAn`tAstIk
fantasy	`fAnt@si:
far	fa:
farce	fa:s
fare	fE@
farewell	fE@`wEl
far-fetched	fa:-`fEtSt
farm	fa:m
far-reaching	fa:-`ri:tSIN
far-sighted	fa:-`sa:It@d
fart	fa:t
farther	`fa:D@
fascinate	`fAs@nEIt
fashion	`fAS@n
fast	fa:st
fasten	`fa:s@n
fast food	fa:st `fu:d
fat	fAt
fatal	`fEIt@l
fatalistic	fEIt@`lIstIk
fatality	f@`tAl@ti:
fat cat	`fAt kAt
fate	fEIt
father	`fa:D@
father-in-law	`fa:D@r-In-l@:
fatigue	f@`ti:g
fatso	`fAts@U
fault	fOlt, f@:lt
fauna	`f@:n@
favour	`fEIv@
favourable	`fEIv@r@b@l, -vr@b@l
favourite	`fEIv@r@t, -vr@t
fax	fAks
faze	fEIz
fearful	`fI@f@l
feasible	`fi:z@b@l
feast	fi:st
feat	fi:t
	`fED@
feature	`fi:tS@
Feb.	
February	`fEbru:@ri:
fed	fEd
federal	`fEd@r@l, `fEdr@l
federate	`fEd@rEIt
fee	fi:
feeble	`fi:b@l
feed	fi:d
feedback	`fi:dbAk
feel	fi:l
feeler	`fi:l@
feeling	`fi:lIN
feet	fi:t
feign	fEIn
fell	fEl
fellow	`fEl@U, `fEl@
felony	`fEl@ni:
felt	fElt
female	`fi:mEIl
feminine	`fEm@n@n
feminist	`fEm@n@st
fence	fEns
fencing	`fEnsIN
fend	fEnd
feral	`fEr@l
ferment	f@`mEnt
ferocious	f@`r@US@s
	`fEr@s wi:l
ferry	`fEri:
fertile	`f@:ta:Il
fertilisation	f@:t@la:I`zEIS@n
fertiliser	`f@:t@la:Iz@
fervent	`f@:v@nt
fester	`fEst@
festival	`fEst@v@l
festive	`fEstIv
festoon	fEs`tu:n
fetch	fEtS
fete	fEIt
fetid	`fEt@d, `fi:t@d
fetus	`fi:t@s
feud	fju:d
fever	`fi:v@
few	fju:
fiancee	fi:`OnsEI
fiasco	fi:`Ask@U
fib	fIb
fibre	`fa:Ib@
fibreglass	`fa:Ib@gla:s
fibro	`fa:Ibr@U
fiction	`fIkS@n
fiddle	`fIdl
fiddly	`fIdli:
fidelity	f@`dEl@ti:
fidget	`fIdZ@t
field	fi:ld
fierce	fI@s
fiery	`fa:I@ri:
fifteen	fIf`ti:n
fifteenth	fIf`ti:nT
fifth	fIfT
fifty	`fIfti:
fig.	
fight	fa:It
figment	`fIgm@nt
figure	`fIg@
	fa:Il
filial	`fi:li:@l
	`fa:IlIN
Filipino	fIl@`pi:n@U
fill	fIl
fillet	`fIl@t
filling	`fIlIN
film	fIlm
filter	`fIlt@
filthy	`fIlTi:
	fIn
final	`fa:In@l
finale	f@`na:li:
finalise	`fa:In@la:Iz
finalist	`fa:In@l@st
finally	`fa:In@li:
finance	`fa:InAns
financial	f@`nAnS@l, fa:I-
find	fa:Ind
fine	fa:In
finger	`fINg@
fingernail	`fINg@nEIl
fingerprint	`fINg@prInt
finicky	`fInIki:
finish	`fInIS
finite	`fa:Ina:It
fire	fa:I@
firearm	`fa:I@ra:m
firebreak	`fa:I@brEIk
firefighter	`fa:I@fa:It@
fireplace	`fa:I@plEIs
fireproof	`fa:I@pru:f
firewood	`fa:I@wUd
	`fa:I@w@:ks
firm	f@:m
first	f@:st
first-class	`f@:st-kla:s
first-hand	`f@:sthAnd
fish	fIS
fisherman	`fIS@m@n
fishy	`fISi:
fist	fIst
fit	fIt
fitness	`fItn@s
fitting	`fItIN
five	fa:Iv
fix	fIks
fixture	`fIkstS@
fizz	fIz
fizzer	`fIz@
fizzle	`fIz@l
flabbergasted	`flAb@ga:st@d
flaccid	
	flAg
flagon	`flAg@n
flagrant	`flEIgr@nt
flair	flE@
flak	flAk
flake	flEIk
flamboyant	flAm`b@:I@nt
flame	flEIm
flaming	`flEImIN
flammable	`flAm@b@l
flan	flAn
flank	flANk
flannel	`flAn@l
flannelette	flAn@`lEt
flap	flAp
flapjack	`flApdZAk
flare	flE@
flash	flAS
flashback	`flASbAk
flash flood	flAS `flV d
flashlight	`flASla:It
flashy	`flASi:
flask	fla:sk
flat	flAt
flatette	flAt`Et
flatten	`flAt@n
flatter	`flAt@
flatulence	`flAtS@l@ns
flaunt	fl@:nt
flautist	`fl@:t@st
flavour	`flEIv@
flaw	fl@:
flax	flAks
flea	fli:
flea-bitten	`fli:-bItn
flea market	`fli: ma:k@t
fled	flEd
fledgling	`flEdZlIN
flee	fli:
fleece	fli:s
fleet	fli:t
fleeting	`fli:tIN
flesh	flES
flew	flu:
flex	flEks
flexible	`flEks@b@l
flexitime	`flEksi:ta:Im
flick	flIk
flicker	`flIk@
flight	fla:It
flimsy	`flImzi:
flinch	flIntS
fling	flIN
flint	flInt
flip	flIp
flippant	`flIp@nt
	`flIp@
flirt	fl@:t
flit	flIt
float	fl@Ut
flock	flOk
flog	flOg
flood	flV d
floodlight	`flV dla:It
floor	fl@:
floorboard	`fl@:b@:d
flop	flOp
floppy	`flOpi:
flora	`fl@:r@
floral	`flOr@l
florist	`flOr@st
floss	flOs
flour	`fla:U@
flourish	`flV rIS
flout	fla:Ut
flow	fl@U
	`fla:U@
flowerbed	`fla:U@bEd
flowery	`fla:U@ri:
flown	fl@Un
flu	flu:
fluctuate	`flV ktSu:EIt
flue	flu:
fluent	`flu:@nt
fluff	flV f
fluid	`flu:@d
fluke	flu:k
flunk	flV Nk
fluorescent	flU@`rEs@nt
fluoride	`flU@ra:Id, `flu:-
flurry	`flV ri:
flush	flV S
fluster	`flV st@
flute	flu:t
flutter	`flV t@
fly	fla:I
flying saucer	fla:IIN `s@:s@
foal	f@Ul
foam	f@Um
fob	fOb
focus	`f@Uk@s
fodder	`fOd@
foetus	`fi:t@s
fog	fOg
foil	f@:Il
fold	f@Uld
folder	`f@Uld@
foliage	`f@Uli:IdZ
folk	f@Uk
folklore	`f@Ukl@:
follow	`fOl@U
follower	`fOl@U@
following	`fOl@UIN
follow-up	`fOl@U-V p
folly	`fOli:
fond	fOnd
food	fu:d
foodstuff	`fu:dstV f
fool	fu:l
foolproof	`fu:lpru:f
foot	fUt
football	`fUtb@:l
footing	`fUtIN
footnote	`fUtn@Ut
footpath	`fUtpa:T
footprint	`fUtprInt
footstep	`fUtstEp
footwear	`fUtwE@
for	f@:
forage	`fOrIdZ
forbearance	f@:`bE@r@ns
forbid	f@`bId
forbidding	f@`bIdIN
force	f@:s
forceful	`f@:sfUl
forceps	`f@:s@ps
forcible	`f@:s@b@l
ford	f@:d
fore	f@:
forearm	`f@:ra:m
forebear	`f@:bE@
forecast	`f@:ka:st
forefinger	`f@:fINg@
foreground	`f@:gra:Und
forehead	`fOr@d
foreign	`fOr@n
foreman	`f@:m@n
foremost	`f@:m@Ust
forensic	f@`rEnsIk
foresee	f@:`si:
foreshadow	f@:`SAd@U
forest	`fOr@st
forestry	`fOr@stri:
forever	f@r`Ev@
foreword	`f@:w@:d
forfeit	`f@:f@t
forge	f@:dZ
forget	f@`gEt
forgive	f@`gIv
fork	f@:k
forklift	`f@:klIft
forlorn	f@`l@:n
form	f@:m
formal	`f@:m@l
format	`f@:mAt
formation	f@:`mEIS@n
former	`f@:m@
formidable	`f@:m@d@b@l, f@:`mId@b@l
formula	`f@:mj@l@
formulate	`f@:mj@lEIt
forsake	f@`sEIk
fort	f@:t
forte	`f@:tEI
forth	f@:T
forthcoming	f@:T`kV mIN
forthright	`f@:Tra:It
fortify	`f@:t@fa:I
fortnight	`f@:tna:It
fortress	`f@:tr@s
fortunate	`f@:tS@n@t
fortune	`f@:tS@n
forty	`f@:ti:
forum	`f@:r@m
forward	`f@:w@d
fossick	`fOsIk
fossil	`fOs@l
foster	`fOst@
fought	f@:t
foul	fa:Ul
foul-mouthed	`fa:Ul-ma:UDd, `fa:Ul-ma:UTt
found	fa:Und
foundation	fa:Un`dEIS@n
fountain	`fa:Unt@n
fountain pen	`fa:Untn pEn
four	f@:
four-letter word	f@:-lEt@ `w@:d
fourteen	`f@:ti:n
fourteenth	f@:`ti:nT, `f@:ti:nT
fourth	f@:T
four-wheel drive	f@:-wi:l `dra:Iv
fox	fOks
foyer	`f@:I@
fraction	`frAkS@n
fracture	`frAktS@
fragile	`frAdZa:Il
fragment	`frAgm@nt
fragrance	`frEIgr@ns
frail	frEIl
frame	frEIm
framework	`frEImw@:k
franchise	`frAntSa:Iz
frank	frANk
frankfurt	`frANkf@t
frantic	`frAntIk
fraternal	fr@`t@:nl
fraud	fr@:d
fraught	fr@:t
fray	frEI
frazzled	`frAz@ld
freak	fri:k
freckle	`frEk@l
free	fri:
freebie	`fri:bi:
freedom	`fri:d@m
free-for-all	`fri:-f@r-@:l
freehand	`fri:hAnd
freehold	`fri:h@Uld
freelance	`fri:lAns
freeloader	`fri:l@Ud@
free-range	`fri:-rEIndZ
freestyle	`fri:sta:Il
freeway	`frIwEI
freeze	fri:z
freeze-dry	`fri:z-dra:I
freezer	`fri:z@
freight	frEIt
French	frEntS
frenetic	fr@`nEtIk
frenzy	`frEnzi:
frequency	`fri:kw@nsi:
frequent	`fri:kw@nt
fresh	frES
freshwater	`frESw@:t@
fret	frEt
friction	`frIkS@n
Friday	`fra:IdEI
fridge	frIdZ
fried	fra:Id
friend	frEnd
friendly	`frEndli:
friendship	`frEndSIp
fright	fra:It
frighten	`fra:It@n
frightful	`fra:ItfUl
frill	frIl
fringe	frIndZ
frisk	frIsk
fritter	`frIt@
frivolous	`frIv@l@s
frizzy	`frIzi:
frock	frOk
frog	frOg
frogman	`frOgm@n
frolic	`frOlIk
from	frOm
front	frV nt
frontier	frV n`tI@
frost	frOst
frostbite	`frOstba:It
froth	frOT
frown	fra:Un
froze	fr@Uz
frozen	`fr@Uz@n
frugal	`fru:g@l
fruit	fru:t
fruitcake	`fru:tkEIk
frustrate	frV s`trEIt, `frV strEIt
fry	fra:I
fuck	fV k
fuckwit	`fV kwIt
fudge	fV dZ
fuel	`fju:@l
fugitive	`fju:dZ@tIv
fulfil	fUl`fIl
full	fUl
full stop	fUl `stOp
full-time	fUl-`ta:Im
fully-fledged	`fUli:-flEdZd
fumble	`fV mbl
fume	fju:m
fumigate	`fju:m@gEIt
fun	fV n
function	`fV NkS@n
functional	`fV NkS@n@l
fund	fV nd
fundamental	fV nd@`mEntl
funeral	`fju:nr@l
fungus	`fV Ng@s
funnel	`fV nl
funnel-web	`fV n@lwEb
funny	`fV ni:
fur	f@:
furious	`fju:ri:@s
furnace	`f@:n@s
furnish	`f@:nIS
furniture	`f@:nItS@
furore	`fju:r@:
furrow	`fV r@U
further	`f@:D@
furthest	`f@:D@st
furtive	`f@:tIv
fury	`fju:ri:
fuse	fju:z
fuss	fV s
fussy	`fV si:
futile	`fju:ta:Il
future	`fju:tS@
future tense	fju:tS@ `tEns
fuzz	fV z
fuzzy	`fV zi:
G, g	dZi:
G	dZi:
g	
gable	`gEIb@l
gadget	`gAdZ@t
gag	gAg
gaggle	`gAg@l
gaiety	`gEI@ti:
gain	gEIn
gait	gEIt
gala	`ga:l@
galah	g@`la:
galaxy	`gAl@ksi:
gale	gEIl
gall bladder	`g@:l blAd@
gallery	`gAl@ri:
gallon	`gAl@n
gallop	`gAl@p
gallstone	`g@:lst@Un
gallup poll	`gAl@p p@Ul
galore	g@`l@:
galvanise	`gAlv@na:Iz
gamble	`gAmb@l
game	gEIm
gaming	`gEImIN
gang	gAN
gangrene	`gANgri:n
gangster	`gANst@
gaol	dZEIl
gap	gAp
gape	gEIp
garage	`gAra:Z, g@`ra:Z, -`ra:dZ
garbage	`ga:bIdZ
garden	`ga:dn
gardener	`ga:dn@
gargle	`ga:g@l
garish	`gE@rIS, `ga:-
garlic	`ga:lIk
garment	`ga:m@nt
garnish	`ga:nIS
garret	`gAr@t
gas	gAs
gash	gAS
gasket	`gAsk@t
gasp	gAsp, ga:sp
gastric	`gAstrIk
gate	gEIt
gatecrash	`gEItkrAS
gather	`gAD@
gaudy	`g@:di:
gauge	gEIdZ
gaunt	g@:nt
gauze	g@:z
gave	gEIv
gawk	g@:k
gawky	`g@:ki:
gay	gEI
gaze	gEIz
gazump	g@`zV mp
Gdns	
GDP	dZi: di: `pi:
gear	gI@
gel	dZEl
gelatine	`dZEl@ti:n, dZEl@`ti:n
gem	dZEm
gender	`dZEnd@
gene	dZi:n
general	`dZEnr@l
generate	`dZEn@rEIt
generation	dZEn@`rEIS@n
generic	dg@`nErIk
generous	`dZEn@r@s, `dZEnr@s
genesis	`dZEn@s@s
genetics	dZ@`nEtIks
genial	`dZi:ni:@l
genitals	`dZEn@tlz
genius	`dZi:ni:@s
genocide	`dZEn@sa:Id
genre	`ZOnr@
gentile	`dZEnta:Il
gentle	`dZEntl
gentleman	`dZEntlm@n
genuine	`dZEnju:@n
geography	dZi:`Ogr@fi:
geology	dZi:`Ol@dZi:
geometry	dZi:`Om@tri:
geriatric	dZEri:`AtrIk
geriatrics	dZEri:`AtrIks
germ	dZ@:m
German	`dZ@:m@n
gerrymander	`dZEri:mAnd@
gesticulate	dZEs`tIkj@lEIt
gesture	`dZEstS@
get	gEt
ghastly	`ga:stli:
gherkin	`g@:k@n
ghetto	`gEt@U
ghost	g@Ust
giant	`dZa:I@nt
gibber	`dZIb@
gibberish	`dZIb@rIS
giddy	`gIdi:
gift	gIft
gigantic	dZa:I`gAntIk
giggle	`gIg@l
gild	gIld
gilt	gIlt
gimmick	`gImIk
ginger	`dZIndZ@
gingerly	`dZIndZ@li:
gingham	`gIN@m
gipsy	`dZIpsi:
girl	g@:l
girlfriend	`g@:lfrEnd
girth	g@:T
gist	dZIst
give	gIv
given name	`gIv@n nEIm
glacier	`glEIsi:@
glad	glAd
glamour	`glAm@
glance	glAns
gland	glAnd
glare	glE@
glaring	`glE@rIN
glass	gla:s
gleam	gli:m
glean	gli:n
glee	gli:
glib	glIb
glide	gla:Id
glimmer	`glIm@
glimpse	glImps
glint	glInt
glisten	`glIs@n
glitter	`glIt@
gloat	gl@Ut
globe	gl@Ub
gloomy	`glu:mi:
glorious	`gl@:ri:@s
glory	`gl@:ri:
gloss	glOs
glossary	`glOs@ri:
glove	glV v
glow	gl@U
glucose	`glu:k@Us
glue	glu:
glum	glV m
glut	glV t
glutton	`glV t@n
gnash	nAS
gnaw	n@:
GNP	dZi: En `pi:
go	g@U
goal	g@Ul
goalkeeper	`g@Ulki:p@
goat	g@Ut
gobble	`gOb@l
god	gOd
goggle	`gOg@l
gold	g@Uld
golden	`g@Uld@n
golden syrup	g@Uld@n `sIr@p
goldmine	`g@Uldma:In
golf	gOlf
gone	gOn
gonorrhoea	gOn@`ri:@
good	gUd
goodbye	gUd`ba:I
goodness	`gUdn@s
goods	gUdz
goose	gu:s
gorge	g@:dZ
gorgeous	`g@:dZ@s
gosh	gOS
gossip	`gOs@p
got	gOt
gouge	ga:UdZ
gourmet	`g@:ma:I
gout	ga:Ut
govern	`gV v@n
government	`gV v@nm@nt
Governor	`gV v@n@, `gV vn@
Governor-General	gV v@n@-`dZEnr@l
Govt	
gown	ga:Un
GP	dZi: `pi:
GPO	dZi: pi: `@U
grab	grAb
grace	grEIs
gracious	`grEIS@s
grade	grEId
gradual	`grAdZu:@l
graduate	`grAdZu:@t
graffiti	gr@`fi:ti:
graft	gra:ft
grain	grEIn
gram	grAm
grammar	`grAm@
gran	grAn
grand	grAnd
grandchild	`grAntSa:Ild
granddaughter	`grAnd@:t@
grandfather	`grAnfa:D@, `grAnd-
grandiose	`grAndi:@Us
grandmother	`grAnmV D@, `grAnd-
grandparent	`grAnpE@r@nt
grandson	`grAnsV n, `grAnd-
grandstand	
granite	`grAn@t
Granny Smith	grAni: `smIT
grant	grAnt, gra:nt
grape	grEIp
graph	grAf, gra:f
graphic	`grAfIk
graphite	`grAfa:It
grapple	`grAp@l
grasp	grAsp, gra:sp
grasping	`grAspIN, `gra:sp-
grass	gra:s
grassroots	gra:s`ru:ts, `gra:sru:ts
grate	grEIt
grateful	`grEItfUl
	`grEIt@
	`grEItIN
gratitude	`grAt@tSu:d
grave	grEIv
gravel	`grAv@l
graveyard	`grEIvja:d
gravitate	`grAv@tEIt
gravity	`grAv@ti:
gravy	`grEIvi:
graze	grEIz
grazier	`grEIzi:@
grease	gri:s
greaseproof	`gri:spru:f
great	grEIt
greedy	`gri:di:
Greek	gri:k
green	gri:n
greengrocer	`gri:ngr@Us@
greenhouse	`gri:nha:Us
greet	gri:t
greeting	`gri:tIN
grenade	gr@`nEId
grevillea	gr@`vIli:@
grew	gru:
grey	grEI
	grId
grief	gri:f
grievance	`gri:v@ns
grill	grIl
grille	grIl
grim	grIm
grimace	`grIm@s, gr@`mEIs
grime	gra:Im
grin	grIn
grind	gra:Ind
grip	grIp
gripe	gra:Ip
grisly	`grIzli:
gristle	`grIs@l
grit	grIt
grizzle	`grIz@l
groan	gr@Un
grocer	`gr@Us@
groceries	`gr@Us@ri:z
grog	grOg
groggy	`grOgi:
groin	gr@:In
groom	gru:m
groomsman	`gru:mzm@n
groove	gru:v
grope	gr@Up
gross	gr@Us
grotesque	gr@U`tEsk
grotty	`grOti:
grouch	gra:UtS
ground	gra:Und
groundwork	`gra:Undw@:k
group	gru:p
grout	gra:Ut
grovel	`grOv@l
grow	gr@U
growl	gra:Ul
grown	gr@Un
growth	gr@UT
grub	grV b
grubby	`grV bi:
grudge	grV dZ
grudging	`grV dZIN
gruelling	`gru:@lIN
gruesome	`gru:s@m
gruff	grV f
grumble	`grV mb@l
grumpy	`grV mpi:
grunt	grV nt
guarantee	gAr@n`ti:
guard	ga:d
guardian	`ga:di:@n
guerilla	g@`rIl@
guess	gEs
guest	gEst
guffaw	gV `f@:, g@-
guidance	`ga:Id@ns
guide	ga:Id
guile	ga:Il
guilt	gIlt
guitar	g@`ta:
gulf	gV lf
gullet	`gV l@t
gullible	`gV l@b@l
gully	`gV li:
gulp	gV lp
gum	gV m
gumboot	`gV mbu:t
gun	gV n
gurgle	`g@:g@l
gush	gV S
gust	gV st
gusto	`gV st@U
gut	gV t
gutter	`gV t@
guy	ga:I
guzzle	`gV z@l
gym	dZIm
gymnasium	dZIm`nEIzi:@m
gymnastics	dZIm`nAstIks
gynaecologist	ga:In@`kOl@dZ@st
gypsy	`dZIpsi:
H, h	EItS
habit	`hAb@t
habitat	`hAb@tAt
hack	hAk
hacksaw	`hAks@:
had	hAd
hadn't	`hAdnt
haemoglobin	hi:m@`gl@Ub@n
haemophilia	hi:m@`fIli:@
haemorrhage	`hEm@rIdZ
haemorrhoid	`hEm@r@:i:d
haggard	`hAg@d
haggle	`hAg@l
hail	hEIl
hair	hE@
haircut	`hE@kV t
hairdo	`hE@du:
hairdresser	`hE@drEs@
hair-raising	`hE@rEIzIN
hairstyle	`hE@sta:Il
half	ha:f
half-brother	`ha:f-brV D@
half-hearted	`ha:f-ha:t@d
half-sister	`ha:f-sIst@
halfway	`ha:fwEI
hall	h@:l
hallmark	`h@:lma:k
hallucinate	h@`lu:s@nEIt
hallway	`h@:lwEI
halo	`hEIl@U
halt	h@:lt, hOlt
halve	ha:v
ham	hAm
hamburger	`hAmb@:g@
	`hAm@
hammock	`hAm@k
hamper	`hAmp@
hamstring	`hAmstrIN
hand	hAnd
handbag	`hAndbAg
handcuffs	`hAndkV fs
handful	`hAndfUl
handicap	`hAndIkAp
handicraft	`hAndi:kra:ft
handkerchief	`hANk@tS@f
handle	`hAndl
handmade	`hAndmEId
handout	`hAnda:Ut
handshake	`hAndSEIk
handsome	`hAns@m
hands-on	hAndz-`On
handwriting	`hAndra:ItIN
handy	`hAndi:
hang	hAN
hangar	`hAN@
hanger	`hAN@
hang-glider	`hAN-gla:Id@
hangover	`hAN@Uv@
hang-up	`hAN-V p
hankie	`hANki:
haphazard	hAp`hAz@d
happen	`hAp@n
happy	`hApi:
harass	`hAr@s, h@`rAs
harbour	`ha:b@
hard	ha:d
hardly	`ha:dli:
hardship	`ha:dSIp
hardware	`ha:dwE@
hardy	`ha:di:
harm	ha:m
harmony	`ha:m@ni:
harness	`ha:n@s
harp	ha:p
harpoon	ha:`pu:n
harsh	ha:S
harvest	`ha:v@st
has	hAz
hash	hAS
hassle	`hAs@l
haste	hEIst
hat	hAt
hatch	hAtS
hatchback	`hAtSbAk
hatchet	`hAtS@t
hate	hEIt
hat-trick	`hAt-trIk
haughty	`h@:ti:
haul	h@:l
haunt	h@:nt
have	hAv
haven	`hEIv@n
havoc	`hAv@k
hawk	h@:k
hay	hEI
hay fever	`hEI fi:v@, hEI `fi:v@
haywire	`hEIwa:I@
hazard	`hAz@d
haze	hEIz
hazel	`hEIz@l
he	hi:
head	hEd
headache	`hEdEIk
heading	`hEdIN
headland	`hEdl@nd, -lAnd
headlight	`hEdla:It
headline	`hEdla:In
head-on	hEd-`On
headquarters	`hEdkw@:t@z, hEd`kw@:t@z
head start	hEd `sta:t
headstone	`hEdst@Un
headstrong	`hEdstrON
headteacher	
headway	`hEdwEI
headwind	`hEdwInd
heal	hi:l
health	hElT
heap	hi:p
hear	hI@
hearing	`hI@rIN
hearing aid	`hI@rIN EId
hearsay	`hI@sEI
hearse	h@:s
heart	ha:t
heartache	`ha:tEIk
heartbreak	`ha:tbrEIk
heartburn	`ha:tb@:n
hearten	`ha:t@n
heartless	`ha:tl@s
hearty	`ha:ti:
heat	hi:t
heater	`hi:t@
heatwave	`hi:twEIv
heave	hi:v
heaven	`hEv@n
heavy	`hEvi:
heckle	`hEk@l
hectare	`hEktE@
hectic	`hEktIk
	hEdZ
heel	hi:l
hefty	`hEfti:
heifer	`hEf@
height	ha:It
heighten	`ha:It@n
heir	E@
heirloom	`E@lu:m
held	hEld
helicopter	`hEl@kOpt@
heliport	`hEli:p@:t
hell	hEl
hello	hV `l@U, h@-
helm	hElm
helmet	`hElm@t
help	hElp
helping	`hElpIN
helpless	`hElpl@s
hem	hEm
hemisphere	`hEm@sfI@
hemline	`hEmla:In
hemp	hEmp
hen	hEn
hence	hEns
henceforth	hEns`f@:T
hepatitis	hEp@`ta:It@s
her	h@:
herald	`hEr@ld
herb	h@:b
herd	h@:d
here	hI@
heredity	h@`rEd@ti:
heresy	`hEr@si:
heritage	`hEr@tIdZ
hermit	`h@:m@t
hernia	`h@:ni:@
hero	`hI@r@U
heroin	`hEr@w@n
heroine	`hEr@w@n
herpes	`h@:pi:z
hers	h@:z
herself	h@`sElf
hesitate	`hEz@tEIt
heterosexual	hEt@r@U`sEkSu:@l
hew	hju:
heyday	`hEIdEI
hibernate	`ha:Ib@nEIt
hiccup	`hIkV p
hidden	`hIdn
hide	ha:Id
hideaway	`ha:Id@wEI
hideous	`hIdi:@s
hierarchy	`ha:I@ra:ki:
hi-fi	`ha:I-fa:I
high	ha:I
highbrow	`ha:Ibra:U
highland	`ha:Il@nd
highlight	`ha:Ila:It
highlighter	`ha:Ila:It@
highly	`ha:Ili:
high school	`ha:I sku:l
high season	`ha:I si:z@n
highway	`ha:IwEI
hijack	`ha:IdZAk
hike	ha:Ik
hilarious	h@`lE@ri:@s
hill	hIl
hilt	hIlt
him	hIm
himself	hIm`sElf
hind	ha:Ind
hinder	`hInd@
hindsight	`ha:Indsa:It
Hinduism	`hIndu:Iz@m
hinge	hIndZ
hint	hInt
hip	hIp
hire	`ha:I@
hire-purchase	ha:I@-`p@:tS@s
his	hIz
hiss	hIs
historic	hI`stOrIk
historical	hI`stOrIk@l
history	`hIstri:, `hIst@ri:
hit	hIt
hit-and-run	hIt-n-`rV n
hitch	hItS
hitchhike	`hItSha:Ik
hitherto	hID@`tu:
hive	ha:Iv
hoard	h@:d
hoarding	`h@:dIN
hoarse	h@:s
hoax	h@Uks
hobble	`hOb@l
hobby	`hObi:
hobbyhorse	`hObi:h@:s
hockey	`hOki:
hoe	h@U
hog	hOg
hoist	h@:Ist
hold	h@Uld
hold-up	`h@Uld-V p
hole	h@Ul
holiday	`hOl@dEI
hollow	`hOl@U
holocaust	`hOl@kOst
hologram	`hOl@grAm
holster	`h@Ulst@
holy	`h@Uli:
homage	`hOmIdZ
home	h@Um
homeland	`h@UmlAnd
homesick	`h@UmsIk
homestead	`h@UmstEd
home unit	`h@Um ju:n@t
homework	`h@Umw@:k
homicide	`hOm@sa:Id
homoeopathy	h@Umi:`Op@Ti:
homogeneous	h@Um@`dZi:ni:@s, hOm@-
homosexual	h@Um@U`sEkSu:@l, hOm@-
honest	`On@st
honey	`hV ni:
	`hV ni:k@Um
honeymoon	`hV ni:mu:n
honorary	`On@r@ri:
honour	`On@
honourable	`On@r@b@l
hood	hUd
hoodlum	`hu:dl@m
hoodwink	`hUdwINk
hoof	hu:f
	hUk
hooligan	`hu:l@g@n
hoon	hu:n
hoop	hu:p
hop	hOp
hope	h@Up
hopeful	`h@UpfUl
hopeless	`h@Upl@s
horde	h@:d
horizon	h@`ra:Iz@n
horizontal	hOr@`zOntl
hormone	`h@:m@Un
horn	h@:n
horoscope	`hOr@sk@Up
horrendous	h@`rEnd@s
horrible	`hOr@b@l
horrify	`hOr@fa:I
horror	`hOr@
hors d'oeuvre	@: `d@:v
horse	h@:s
horseshoe	`h@:sSu:
horticulture	`h@:t@kV ltS@
hose	h@Uz
hosiery	`h@UZ@ri:
hospice	`hOsp@s
hospital	`hOsp@tl
hospitality	hOsp@`tAl@ti:
host	h@Ust
hostage	`hOstIdZ
hostel	`hOst@l, hOs`tEl
hostile	`hOsta:Il
hot	hOt
hot chips	hOt `tSIps
hot dog	`hOt dOg, hOt `dOg
hotel	h@U`tEl
hothouse	`hOtha:Us
hotline	`hOtla:In
hotplate	`hOtplEIt
hound	ha:Und
hour	a:U@
house	ha:Us
housebreaker	`ha:UsbrEIk@
household	`ha:Ush@Uld
housekeeping	`ha:Uski:pIN
house-warming	`ha:Us-w@:mIN
housewife	`ha:Uswa:If
housework	`ha:Usw@:k
hovel	`hOv@l
hover	`hOv@
hovercraft	`hOv@kra:ft
how	ha:U
however	ha:U`Ev@
howl	ha:Ul
HQ	EItS`kju:
hr	a:U@
HSC	EItS Es `si:
ht	ha:It
hub	hV b
huddle	`hV dl
hue	hju:
hug	hV g
huge	hju:dZ
hulk	hV lk
hull	hV l
hullo	`hV l@U, h@`l@U
hum	hV m
human	`hju:m@n
humane	hju:;`mEIn
humanitarian	hju:;mAn@`tE@ri:@n
humanity	hju:`mAn@ti:
humble	`hV mb@l
humdrum	`hV mdrV m
humid	`hju:m@d
humiliate	hju:`mIli:EIt
humility	hju:`mIl@ti:
humour	`hju:m@
	hV mp
humpy	`hV mpi:
hunch	hV ntS
hundred	`hV ndr@d
hung	hV N
Hungarian	hV N`gE@ri:@n
hunger	`hV Ng@
hunt	hV nt
hurdle	`h@:dl
hurl	h@:l
hurray	h@`rEI
hurricane	`hV r@k@n, -Ik@n
hurry	`hV ri:
hurt	h@:t
hurtful	`h@:tfUl
hurtle	`h@:tl
husband	`hV zb@nd
hush	hV S
husk	hV sk
husky	`hV ski:
hustle	`hV s@l
hut	hV t
hutch	hV tS
hwy	`ha:IwEI
hybrid	`ha:IbrId
hydrant	`ha:Idr@nt
hydraulic	ha:I`drOlIk
hydro-electric	ha:Idr@U-@`lEktrIk
hydrofoil	`ha:Idr@f@:Il
hydroponics	ha:Idr@`pOnIks
hygiene	`ha:IdZi:n
hymn	hIm
hype	ha:Ip
hyped-up	`ha:Ipt-V p
hyphen	`ha:If@n
hypnosis	hIp`n@Us@s
hypochondriac	ha:Ip@`kOndri:Ak
hypocrite	`hIp@krIt
hypodermic	ha:Ip@`d@:mIk
hypothesis	ha:I`pOT@s@s
hysterectomy	hIst@`rEkt@mi:
hysteria	hIs`tI@ri:@
I, i	a:I
I	a:I
ice	a:Is
iceberg	`a:Isb@:g
ice-cream	`a:Is-kri:m
icicle	`a:IsIk@l
icing	`a:IsIN
ID	a:I`di:
idea	a:I`dI@
ideal	a:I`di:l
identical	a:I`dEntIk@l
identification	a:I;dEnt@f@`kEIS@n
identify	a:I`dEnt@fa:I
identity	a:I`dEnt@ti:
idiom	`Idi:@m
idiot	`Idi:@t
idle	`a:Idl
idol	`a:Idl
i.e.	a:I`i:
if	If
ignite	Ig`na:It
ignition	Ig`nIS@n
ignorant	`Ign@r@nt
ignore	Ig`n@:
ill	Il
illegal	I`li:g@l
illegible	I`lEdZ@b@l
illegitimate	Il@`dZIt@m@t
illicit	I`lIs@t
illiterate	I`lIt@r@t
illuminate	I`lu:m@nEIt
illusion	I`lu:Z@n
illustrate	`Il@strEIt
image	`ImIdZ
imaginary	I`mAdZ@n@ri:, -@nri:
imagination	ImAdZ@`nEIS@n
imagine	I`mAdZ@n
imam	`Ima:m
imbecile	`Imb@si:l, -sa:Il
imitate	`Im@tEIt
immaculate	I`mAkju:l@t, -kj@-
immature	`Im@tSU@, -tS@:
immediate	I`mi:di:@t
immense	I`mEns
immerse	I`m@:s
immigrant	`Im@gr@nt
imminent	`Im@n@nt
immoral	I`mOr@l
immortal	I`m@:t@l
immune	I`mju:n
impact	`ImpAkt
impair	Im`pE@
impartial	Im`pa:S@l
impatient	Im`pEIS@nt
impede	Im`pi:d
imperative	Im`pEr@tIv
imperfect	i:m`p@:fEkt
imperial	Im`pI@ri:@l
impersonal	Im`p@:s@n@l
impersonate	Im`p@:s@nEIt
impertinent	Im`p@:t@n@nt
impetuous	Im`pEtju:@s
implement	`Impl@mEnt
implicate	`Impl@kEIt
implication	Impl@`kEIS@n
implicit	Im`plIs@t
implore	Im`pl@:
imply	Im`pla:I
impolite	Imp@`la:It
import	Im`p@:t, `Imp@:t
important	Im`p@:t@nt
impose	Im`p@Uz
imposing	Im`p@UzIN
impossible	Im`pOs@b@l
imposter	Im`pOst@
impotent	`Imp@t@nt
impress	Im`prEs
impression	Im`prES@n
imprison	Im`prIz@n
improve	Im`pru:v
impudent	`Impju:d@nt, -pj@-
impulse	`ImpV ls
impure	Im`pjU@
in	In
in-	In-
inaccurate	I`nAkjUr@t
inadequate	I`nAd@kw@t
inane	I`nEIn
inanimate	I`nAn@m@t
inappropriate	In@`pr@Upri:@t
incapacitate	Ink@`pAs@tEIt
incentive	In`sEntIv
incessant	In`sEs@nt
incest	`InsEst
inch	IntS
incidence	`Ins@d@ns
incident	`Ins@d@nt
incidental	Ins@`dEntl
incinerate	In`sIn@rEIt
incite	In`sa:It
incline	`INkla:In
inclined	IN`kla:Ind
include	IN`klu:d
inclusive	IN`klu:sIv
incoherent	INk@U`hI@r@nt
income	`InkV m, `IN-
incoming	`InkV mIN
incompetent	IN`kOmp@t@nt
inconvenient	INk@n`vi:ni:@nt
incorporate	IN`k@:p@rEIt
increase	IN`kri:s
incredible	IN`krEd@b@l
incur	IN`k@:
indebted	In`dEt@d
indecent	In`di:s@nt
indeed	In`di:d
indefinite	In`dEfn@t
indent	In`dEnt
independent	Ind@`pEnd@nt
index	`IndEks
indicate	`Ind@kEIt, -dIkEIt
indicator	`Ind@kEIt@, `IndI-
indifferent	In`dIfr@nt
indigenous	In`dIdZ@n@s
indigestion	Ind@`dZEstS@n
indignant	In`dIgn@nt
indispensable	Ind@s`pEns@b@l
indisposed	Ind@s`p@Uzd
indisputable	Ind@s`pju:t@b@l
individual	Ind@`vIdZu:@l
indoctrinate	In`dOktr@nEIt
indolent	`Ind@l@nt
Indonesian	Ind@`ni:Z@n
indoors	In`d@:z
induce	In`dju:s
indulge	In`dV ldZ
industry	`Ind@stri:
inept	In`Ept
inevitable	In`Ev@t@b@l
inevitably	In`Ev@t@bli:
inexperience	In@k`spI@ri:@ns
infamous	`Inf@m@s
infant	`Inf@nt
infatuated	In`fAtSu:EIt@d
infection	In`fEkS@n
infectious	In`fEkS@s
infer	In`f@:
inferior	In`fI@ri:@
infest	In`fEst
infidelity	Inf@`dEl@ti:
infiltrate	`Inf@ltrEIt
infinite	`Inf@n@t
infinitive	In`fIn@tIv
inflame	In`flEIm
inflammable	In`flAm@b@l
inflate	In`flEIt
inflation	In`flEIS@n
inflect	In`flEkt
inflexible	In`flEks@b@l
inflict	In`flIkt
influence	`Influ:@ns
influenza	Influ:`Enz@
influx	`InflV ks
inform	In`f@:m
informal	In`f@:m@l
information	Inf@`mEIS@n
infuriate	In`fju:ri:EIt
ingenious	In`dZi:ni:@s
ingrained	`IngrEInd
ingratiate	In`grEISi:EIt
ingredient	In`gri:di:@nt
inhabit	In`hAb@t
inhale	In`hEIl
inherit	In`hEr@t
initial	I`nIS@l
initiate	I`nISi:EIt
initiative	I`nISi:@tIv
inject	In`dZEkt
injure	`IndZ@
injustice	In`dZV st@s
ink	INk
inkling	`INklIN
inlaid	`InlEId
inland	`InlAnd
in-laws	`In-l@:z
inmate	`InmEIt
inner	`In@
innings	`InINz
innocent	`In@s@nt
innumerable	I`nju:m@r@b@l, I`nju:mr@b@l
inoculate	I`nOkju:lEIt
in-patient	`In-pEIS@nt
inquest	`INkwEst
inquire	IN`kwa:I@
inquisitive	IN`kwIz@tIv
ins and outs	Inz @n `a:Uts
insane	In`sEIn
insect	`InsEkt
insecticide	In`sEkt@sa:Id
insecure	Ins@`kju:@
insensitive	In`sEns@tIv
insert	In`s@:t
inside	In`sa:Id
insinuate	In`sInju:EIt
insipid	In`sIp@d
insist	In`sIst
insolent	`Ins@l@nt
inspect	In`spEkt
inspire	In`spa:I@
instalment	In`st@:lm@nt
instance	`Inst@ns
instant	`Inst@nt
instead	In`stEd
instinct	`InstINkt
institute	`Inst@tSu:t
institution	Inst@`tju:S@n
instruct	In`strV kt
instruction	In`strV kS@n
instrument	`Instr@m@nt
insubordinate	Ins@`b@:d@n@t
insubstantial	Ins@b`stAnS@l
insufferable	In`sV f@r@b@l, -fr@b@l
insulate	`InS@lEIt
insulin	`InS@l@n, -sj@l@n
insult	In`sV lt
insure	In`S@:, -SU@
intact	In`tAkt
integral	`Int@gr@l
integrate	`Int@grEIt
integrity	In`tEgr@ti:
intellect	`Int@lEkt
intelligence	In`tEl@dZ@ns
intelligent	In`tEl@dZ@nt
intend	In`tEnd
intense	In`tEns
intensive	In`tEnsIv
intention	In`tEnS@n
interact	Int@r`Akt
intercept	Int@`sEpt
intercourse	`Int@k@:s
interest	`Intr@st, -t@r@st
interesting	`Intr@stIN
interfere	Int@`fI@
interim	`Int@r@m
interior	In`tI@ri:@
interjection	Int@`dZEkS@n
interlude	`Int@lu:d
intermediate	Int@`mi:di:@t
intermission	Int@`mIS@n
intermittent	Int@`mIt@nt
internal	In`t@:n@l
international	Int@`nAS@n@l
interpret	In`t@:pr@t
interrogate	In`tEr@gEIt
interrogative	Int@`rOg@tIv
interrupt	Int@`rV pt
intersection	`Int@`sEkS@n
interstate	`Int@stEIt
interval	`Int@v@l
intervene	Int@`vi:n
interview	`Int@vju:
intestine	In`tEst@n
intimate	`Int@m@t
intimidate	In`tIm@dEIt
into	`Intu:
intonation	Int@`nEIS@n
intoxicated	In`tOks@kEIt@d
intransitive	In`trAns@tIv
intravenous	Intr@`vi:n@s
intrigue	In`tri:g
introduce	Intr@`dju:s
introduction	Intr@`dV kS@n
intrude	In`tru:d
intuition	IntSu:`IS@n
invade	In`vEId
invalid	In`vAl@d
invalid pension	Inv@lId `pEnS@n
invaluable	In`vAlj@b@l
invent	In`vEnt
inverted comma	Inv@:t@d `kOm@
invest	In`vEst
investigate	In`vEst@gEIt
invigorate	In`vIg@rEIt
invisible	In`vIz@b@l
invite	In`va:It
invoice	`Inv@:Is
involve	In`vOlv
involved	In`vOlvd
IOU	a:I @U `ju:
irate	a:I`rEIt
iris	`a:Ir@s
irk	@:k
iron	`a:I@n
irony	`a:Ir@ni:
irrational	I`rAS@n@l
irregular	I`rEgj@l@
irrelevant	I`rEl@v@nt
irrigate	`Ir@gEIt
irritate	`Ir@tEIt
is	Iz
-ish	-IS
Islam	`IzlAm, -la:m
island	`a:Il@nd
isolate	`a:Is@lEIt
issue	`ISu:, `ISju:
it	It
Italian	I`tAlj@n, @`tAl-
italics	I`tAlIks
itch	ItS
item	`a:It@m
itinerary	a:I`tIn@ri:
its	Its
it's	Its
itself	It`sElf
I've	a:Iv
ivy	`a:Ivi:
J, j	dZEI
jab	dZAb
jabber	`dZAb@
jabiru	dZAb@`ru:
	dZAk
jackeroo	dZAk@`ru:
jacket	`dZAk@t
jackknife	`dZAkna:If
jackpot	`dZAkpOt
jade	dZEId
jaded	`dZEId@d
jagged	`dZAg@d
jail	dZEIl
jam	dZAm
jamb	dZIm
Jan.	`dZAnju:@ri:, dZAn
jangle	`dZANg@l
January	`dZAnju:@ri:
Japanese	dZAp@`ni:z
jar	dZa:
jargon	`dZa:g@n
jarrah	`dZAr@
jaundice	`dZ@:nd@s
jaunt	dZ@:nt
jaunty	`dZ@:nti:
javelin	`dZAv@l@n
jaw	dZ@:
jaywalk	`dZEIw@:k
jazz	dZAz
jealous	`dZEl@s
jeans	dZi:nz
	dZi:p
jeer	dZI@
jelly	`dZEli:
	`dZEli:fIS
jeopardy	`dZEp@di:
jerk	dZ@:k
jersey	`dZ@:zi:
jet	dZEt
jettison	`dZEt@s@n, -z@n
jetty	`dZEti:
jewel	`dZu:@l
jewellery	`dZu:@lri:
Jewish	`dZu:IS
jibe	dZa:Ib
jiffy	`dZIfi:
jig	dZIg
jiggle	`dZIg@l
jigsaw	`dZIgs@:
jillaroo	`dZIl@ru:
jilt	dZIlt
jingle	`dZINg@l
jinx	dZINks
jitters	`dZIt@z
jive	dZa:Iv
jnr	`dZu:nj@
job	dZOb
jobless	`dZObl@s
jockey	`dZOki:
jocular	`dZOkj@l@
jodhpurs	`dZOdp@z
joey	`dZ@Ui:
jog	dZOg
join	dZ@:In
joiner	`dZ@:In@
joint	dZ@:Int
joist	dZ@:Ist
joke	dZ@Uk
joker	`dZ@Uk@
jolly	`dZOli:
jolt	dZ@Ult
jostle	`dZOs@l
jot	dZOt
jotter	`dZOt@
joule	dZu:l
journal	`dZ@:n@l
journalist	`dZ@:n@l@st
journey	`dZ@:ni:
jovial	`dZ@Uvi:@l
joy	dZ@:I
JP	dZEI `pi:
Jr	
jube	dZu:b
jubilant	`dZu:b@l@nt
jubilee	dZu:b@`li:
Judaism	`dZu:dEIz@m
judge	dZV dZ
judgment	`dZV dZm@nt
judicial	dZu:`dIS@l
judicious	dZu:`dIS@s
judo	`dZu:d@U
jug	dZV g
juggle	`dZV g@l
juice	dZu:s
jukebox	`dZu:kbOks
Jul.	dZ@`la:I
July	dZ@`la:I
jumble	`dZV mb@l
jumbo	`dZV mb@U
jumbuck	`dZV mbV k
jump	dZV mp
jumper	`dZV mp@
jumpy	`dZV mpi:
Jun.	dZu:n
junction	`dZV NkS@n
juncture	`dZV NktS@
June	dZu:n
jungle	`dZV Ng@l
junior	`dZu:nj@
junk	dZV Nk
junkie	`dZV Nki:
junta	`dZV nt@
jurisdiction	dZu:r@s`dIkS@n
jury	`dZu:ri:
just	dZV st
justice	`dZV st@s
justice of the peace	`dZV st@s @v D@ pi:s
justify	`dZV st@fa:I
jut	dZV t
jute	dZu:t
juvenile	`dZu:v@na:Il
juxtapose	dZV kst@`p@Uz, `dZV kst@p@Uz
K, k	kEI
k	kEI
kaleidoscope	k@`la:Id@sk@Up
kangaroo	kANg@`ru:
karate	k@`ra:ti:
kayak	`ka:IAk
kebab	k@`bAb
keel	ki:l
keen	ki:n
keep	ki:p
keeper	`ki:p@
keeping	`ki:pIN
keepsake	`ki:psEIk
keg	kEg
kelp	kElp
kennel	`kEn@l
kept	kEpt
kerb	k@:b
kernel	`k@:n@l
kero	`kEr@U
kerosene	kEr@`si:n, `kEr@si:n
ketchup	`kEtS@p
kettle	`kEtl
key	ki:
keyboard	`ki:b@:d
keynote	`ki:n@Ut
kg	kEI`dZi:, `kIl@grAm
khaki	ka:`ki:, `ka:ki:
Khmer	k@`mE@
kibble	`kIb@l
kick	kIk
kid	kId
kidnap	`kIdnAp
kidney	`kIdni:
kill	kIl
killing	`kIlIN
kiln	kIln
kilo	`ki:l@U
kilobyte	`kIl@ba:It
kilogram	`kIl@grAm
kilohertz	`kIl@h@:ts
kilojoule	`kIl@dZu:l
kilometre	k@`lOm@t@, `kIl@mi:t@
kilowatt	`kIl@wOt
kilt	kIlt
kimono	`kIm@n@U, k@`m@Un@U
kin	kIn
kind	ka:Ind
kindergarten	`kInd@ga:tn
kindle	`kInd@l
kindling	`kIndlIN
kindly	`ka:Indli:
kindred	`kIndr@d
kindy	`kIndi:
king	kIN
kingdom	`kINd@m
kink	kINk
kinship	`kInSIp
kiosk	`ki:Osk
kiss	kIs
kit	kIt
kitchen	`kItS@n
kitchenette	kItS@`nEt
kitchen tea	kItS@n `ti:
kite	ka:It
kitsch	kItS
kitten	`kItn
kiwi	`ki:wi:
kJ	`kIl@dZu:l
kleptomania	klEpt@`mEIni:@
km	k@`lOm@t@, `kIl@mi:t@
knack	nAk
knackered	`nAk@d
knapsack	`nApsAk
knave	nEIv
knead	ni:d
knee	ni:
kneecap	`ni:kAp
kneel	ni:l
knew	nju:
knickers	`nIk@z
knick-knack	`nIk-nAk
knife	na:If
knight	na:It
knit	nIt
knitting	`nItIN
	nOb
knock	nOk
	nOt
know	n@U
knowing	`n@UIN
knowledge	`nOlIdZ
known	n@Un
knuckle	`nV k@l
KO	kEI `@U
koala	k@U`a:l@
kookaburra	`kUk@bV r@
Korean	k@`ri:@n
kosher	`k@US@
kung-fu	kV N-`fu:
L, l	El
l	
L	
La	lEIn
	`lEIb@l
Labor	`lEIb@
laboratory	l@`bOr@tri:
Labor Party	`lEIb@ pa:ti:
labour	`lEIb@
	lEIs
lacerate	`lAs@rEIt
lack	lAk
lacquer	`lAk@
lad	lAd
	`lAd@
lady	`lEIdi:
lag	lAg
lager	`la:g@
lagoon	l@`gu:n
laid	lEId
lake	lEIk
lamb	lAm
lame	lEIm
laminate	`lAm@nEIt
lamington	`lAmINt@n
lamp	
land	lAnd
landlady	`lAndlEIdi:
landlord	`lAndl@:d
landmark	`lAndma:k
landscape	`lAndskEIp
landslide	`lAndsla:Id
lane	lEIn
language	`lANwIdZ
lank	lANk
lanky	`lANki:
lantern	`lAnt@n
Lao	la:U
lap	lAp
lapse	lAps
large	la:dZ
larrikin	`lAr@k@n
laryngitis	lAr@n`dZa:It@s
larynx	`lArINks
laser	`lEIz@
lash	lAS
last	la:st
	lAtS
late	lEIt
lately	`lEItli:
later	`lEIt@
latest	`lEIt@st
lather	`lAD@
Latin	`lAtn
latitude	`lAt@tSu:d
latter	`lAt@
lattice	`lAt@s
laugh	la:f
launch	l@:ntS
laundromat	`l@:ndr@mAt
laundry	`l@:ndri:
lavatory	`lAv@tri:
lavender	`lAv@nd@
lavish	`lAvIS
law	l@:
lawful	`l@:f@l
lawn	l@:n
lawnmower	`l@:nm@U@
lawyer	`l@:j@
lax	lAks
laxative	`lAks@tIv
lay	lEI
lay-by	`lEI-ba:I
layer	`lEI@
layout	`lEIa:Ut
lazy	`lEIzi:
lead	li:d
leader	`li:d@
leaf	li:f
league	li:g
leak	li:k
lean	li:n
leant	lEnt
leap	li:p
leapt	lEpt
learn	l@:n
lease	li:s
leash	li:S
least	li:st
leather	`lED@
leave	li:v
lecture	`lEktS@
led	lEd
	lEdZ
ledger	`lEdZ@
leer	lI@
left	lEft
left-handed	lEft-`hAnd@d
leg	lEg
legal	`li:g@l
legend	`lEdZ@nd
leggings	`lEgINz
legible	`lEdZ@b@l
legislation	lEdZ@`slEIS@n
legitimate	l@`dZIt@m@t
leisure	`lEZ@
lemon	`lEm@n
lemonade	lEm@`nEId
lend	lEnd
length	lENT
lengthen	`lENT@n
lenient	`li:ni:@nt
lens	lEnz
lent	lEnt
leotard	`li:@ta:d
lesbian	`lEzbi:@n
less	lEs
lessen	`lEs@n
lesson	`lEs@n
let	lEt
lethal	`li:T@l
letter	`lEt@
leukaemia	lu:`ki:mi:@
level	`lEv@l
lever	`li:v@
levy	`lEvi:
liability	la:I@`bIl@ti:
liable	`la:I@b@l
liaison	li:`EIz@n
liar	`la:I@
libel	`la:Ib@l
liberal	`lIbr@l
Liberal Party of Australia	
liberate	`lIb@rEIt
liberty	`lIb@ti:
library	`la:Ibri:
lice	la:Is
licence	`la:Is@ns
lick	lIk
licorice	`lIk@rIS
	lId
lie	la:I
life	la:If
lifelong	`la:IflON
lifesaver	`la:IfsEIv@
lifetime	`la:Ifta:Im
lift	lIft
light	la:It
	`la:ItnIN
like	la:Ik
likely	`la:Ikli:
limb	lIm
lime	la:Im
limelight	`la:Imla:It
limestone	`la:Imst@Un
limit	`lIm@t
limited company	;lIm@t@d `kV mp@ni:
limp	lImp
line	la:In
linen	`lIn@n
liner	`la:In@
linger	`lINg@
lingerie	`lOnZ@rEI
linguistic	lIN`gwIstIk
liniment	`lIn@m@nt
lining	`la:InIN
link	lINk
linoleum	l@`n@Uli:@m
linseed oil	;lInsi:d `@:Il
lip	lIp
lipstick	`lIpstIk
liquefy	`lIkw@fa:I
liqueur	l@`kju:@
liquid	`lIkw@d
liquidate	`lIkw@dEIt
liquor	`lIk@
lisp	lIsp
list	lIst
listen	`lIs@n
listless	`lIstl@s
lit	lIt
literal	`lItr@l
literary	`lIt@r@ri:
literate	`lIt@r@t
literature	`lItr@tS@
litre	`li:t@
litter	`lIt@
litterbug	`lIt@bV g
little	`lItl
live	lIv
livelihood	`la:Ivli:;hUd
lively	`la:Ivli:
liver	`lIv@
livestock	`la:IvstOk
livid	`lIv@d
living	`lIvIN
lizard	`lIz@d
load	l@Ud
loaf	l@Uf
loam	l@Um
loan	l@Un
loath	l@UT
loathe	l@UD
lob	lOb
lobby	`lObi:
local	`l@Uk@l
locate	l@`kEIt
lock	lOk
locker	`lOk@
locket	`lOk@t
locksmith	`lOksmIT
locomotive	l@Uk@`m@UtIv
lodge	lOdZ
loft	lOft
lofty	`lOfti:
log	lOg
logical	`lOdZIk@l
loiter	`l@:It@
lolly	`lOli:
lone	l@Un
lonely	`l@Unli:
long	lON
longitude	`lONg@tSu:d
look	lUk
lookout	`lUka:Ut
loom	lu:m
loop	lu:p
loophole	`lu:ph@Ul
loose	lu:s
loot	lu:t
lop	lOp
lopsided	lOp`sa:Id@d
lord	l@:d
lorry	`lOri:
lose	lu:z
loss	lOs
lost	lOst
lot	lOt
lotion	`l@US@n
lottery	`lOt@ri:
lotto	`lOt@U
loud	la:Ud
loudspeaker	la:Ud`spi:k@
lounge	la:UndZ
louse	la:Us
lousy	`la:Uzi:
lout	la:Ut
love	lV v
lovely	`lV vli:
low	l@U
lower	`l@U@
loyal	`l@:I@l
lozenge	`lOz@ndZ
LPG	El pi: `dZi:
	`El-plEIt
Ltd	`lIm@t@d
lubricate	`lu:br@kEIt
lucid	`lu:s@d
luck	lV k
lucrative	`lu:kr@tIv
ludicrous	`lu:d@kr@s
lug	lV g
luggage	`lV gIdZ
lukewarm	lu:k`w@:m
lull	lV l
lullaby	`lV l@ba:I
luminous	`lu:m@n@s
lump	lV mp
lunar	`lu:n@
lunatic	`lu:n@tIk
lunch	lV ntS
lung	lV N
lunge	lV ndZ
lurch	l@:tS
lurgy	`l@:gi:
lurid	`lu:r@d
lurk	l@:k
luscious	`lV S@s
lush	lV S
lust	lV st
luxuriant	lV g`Zu:ri:@nt
luxury	`lV kS@ri:
lying	la:I;IN
lyrebird	`la:I@b@:d
M, m	Em
m	
macabre	m@`ka:b
macadamia	mAk@`dEImi:@
macaroni	mAk@`r@Uni:
Macedonian	mAs@`d@Uni:@n
machete	m@`SEti:
machine	m@`Si:n
machinery	m@`S@i:n@ri:
macho	`mAtS@U
mad	mAd
madam	`mAd@m
made	mEId
magazine	mAg@`zi:n
maggot	`mAg@t
magic	`mAdZIk
magistrate	`mAdZ@strEIt
magnanimous	mAg`nAn@m@s
magnate	`mAgnEIt, `mAgn@t
magnet	`mAgn@t
magnificent	mAg`nIf@s@nt
magnify	`mAgn@fa:I
magnifying glass	`mAgn@fa:IIN gla:s
magnitude	`mAgn@tSu:d
magpie	`mAgpa:I
maiden	`mEIdn
mail	mEIl
mail order	`mEIl @:d@
maim	mEIm
main	mEIn
mainland	`mEInlAnd, -l@nd
mainstream	`mEInstri:m
maintain	mEIn`tEIn, m@n-
maitre d'hotel	mEItr@ d@U`tEl
maize	mEIz
majesty	`mAdZ@sti:
major	`mEIdZ@
majority	m@`dZOr@ti:
make	mEIk
make-believe	`mEIk-b@li:v
make-up	`mEIk-V p
maladjusted	mAl@`dZV st@d
malaria	m@`lE@ri:@
male	mEIl
malevolent	m@`lEv@l@nt
malformation	mAlf@:`mEIS@n, -f@-
malice	`mAl@s
malign	m@`la:In
malignant	m@`lIgn@nt
malinger	m@`lINg@
mall	m@:l, mAl
malleable	`mAli:@b@l
mallee	`mAli:
mallet	`mAl@t
malnourished	`mAlnV rISt
malpractice	mAl`prAkt@s
malt	mOlt, m@:lt
maltreat	mAl`tri:t
mammal	`mAm@l
mammoth	`mAm@T
man	mAn
manage	`mAnIdZ
management	`mAnIdZm@nt
manager	`mAn@dZ@
manchester	`mAntS@st@
mandarin	`mAnd@r@n, mAnd@`rIn
mandate	`mAndEIt
mandatory	`mAnd@tri:, -t@ri:
mane	mEIn
mange	mEIndZ
mangle	`mANg@l
mangrove	`mANgr@Uv
mania	`mEIni:@
maniac	`mEIni:Ak
manicure	`mAn@kjU@
manifest	`mAn@f@st
manifesto	mAn@`fEst@U
manipulate	m@`nIpj@lEIt
mankind	mAn`ka:Ind
manly	`mAnli:
manner	`mAn@
mannerism	`mAn@rIz@m
manoeuvre	m@`nu:v@
mansion	`mAnS@n
manslaughter	`mAnsl@:t@
mantlepiece	`mAntlpi:s
manual	`mAnju:@l
manufacture	
manure	m@`njU@
manuscript	`mAnj@skrIpt
many	`mEni:
	mAp
Mar.	
marathon	`mAr@TOn, -T@n
marble	`ma:b@l
march	ma:tS
mare	mE@
margarine	ma:dZ@`ri:n
margin	`ma:dZ@n
marginal	`ma:dZ@n@l
marijuana	mAr@`wa:n@
marina	m@`ri:n@
marinate	`mAr@nEIt
marine	m@`ri:n
marital	`mAr@t@l
maritime	`mAr@ta:Im
mark	ma:k
market	`ma:k@t
marketing	`ma:k@tIN
mark-up	`ma:k-V p
marmalade	`ma:m@lEId
maroon	m@`ru:n
marquee	ma:`ki:
marriage	`mArIdZ
married	`mAri:d
marrow	`mAr@U
marry	`mAri:
marsh	ma:S
marshal	`ma:S@l
marshmallow	ma:S`mAl@U, -`mEl-
marsupial	ma:`sju:pi:@l, -su:p
martyr	`ma:t@
marvel	`ma:v@l
masc.	
mascara	mAs`ka:r@
mascot	`mAskOt
masculine	`mAskj@l@n
mash	mAS
mask	ma:sk
mason	`mEIs@n
masonry	`mEIs@nri:
masquerade	mAsk@`rEId
mass	mAs
massacre	`mAs@k@
massage	`mAsa:Z, `mAsa:dZ
massive	`mAsIv
mast	ma:st
mastectomy	mAs`tEkt@mi:
master	`ma:st@
masterpiece	`ma:st@pi:s
masturbate	`mAst@bEIt
mat	mAt
match	mAtS
mate	mEIt
material	m@`tI@ri:@l
materialise	m@`tI@ri:@la:Iz
materialistic	m@tI@ri:@`lIstIk
maternal	m@`t@:n@l
maternity	m@`t@:n@ti:
mathematics	mAT@`mAtIks
maths	mATs
matinee	`mAt@nEI
matriarch	`mEItri:a:k, `mAt-
matrimony	`mAtr@m@ni:
matt	mAt
matter	`mAt@
mattress	`mAtr@s
mature	m@`tS@:, m@`tSU@
maul	m@:l
mauve	m@Uv
maverick	`mAv@rIk
max.	
maxim	`mAks@m
maximum	`mAks@m@m
may	mEI
May	mEI
maybe	`mEIbi:, mEI`bi:
mayonnaise	mEI@`nEIz
mayor	mE@
maze	mEIz
me	mi:
meagre	`mi:g@
meal	mi:l
mean	mi:n
meander	mi:`And@
means	mi:nz
meantime	`mi:nta:Im
meanwhile	`mi:nwa:Il
measles	`mi:z@lz
measure	`mEZ@
meat	mi:t
mechanic	m@`kAnIk
mechanical	m@`kAnIk@l
mechanics	m@`kAnIks
mechanise	`mEk@na:Iz
mechanism	`mEk@nIz@m
medal	`mEdl
medallion	m@`dAlj@n
meddle	`mEdl
media	`mi:di:@
median	`mi:di:@n
mediate	`mi:di:EIt
medical	`mEdIk@l
Medicare	`mEdi:kE@
medication	mEd@`kEIS@n
medicine	`mEd@s@n, `mEds@n
mediocre	mi:di:`@Uk@, `mi:di:@Uk@
meditate	`mEd@tEIt
medium	`mi:di:@m
medley	`mEdli:
meek	mi:k
meet	mi:t
meeting	`mi:tIN
megabyte	`mEg@ba:It
megaphone	`mEg@f@Un
melancholy	`mEl@nkOli:
melanoma	mEl@`n@Um@
mellow	`mEl@U
melodrama	`mEl@dra:m@
melody	`mEl@di:
melon	`mEl@n
melt	mElt
member	`mEmb@
membrane	`mEmbrEIn
memento	m@`mEnt@U
memo	`mEm@U, `mi:-
memoirs	`mEmwa:z
memorable	`mEmr@b@l
memorial	m@`m@:ri:@l
memorise	`mEm@ra:Iz
memory	`mEm@ri:
men	mEn
menace	`mEn@s
mend	mEnd
menial	`mi:ni:@l
menopause	`mEn@p@:z
menstruate	`mEnstru:a:It
mental	`mEntl
mention	`mEnS@n
menu	`mEnju:, `mi:nju:
mercenary	`m@:s@nri:
merchandise	`m@:tS@nda:Is
mercury	`m@:kj@ri:
mercy	`m@:si:
mere	mI@
merge	m@:dZ
meringue	m@`rAN
merino	m@`ri:n@U
merit	`mEr@t
mermaid	`m@:mEId
merry	`mEri:
merry-go-round	`mEri:-g@U-ra:Und
mesh	mES
mesmerise	`mEzm@ra:Iz
mess	mEs
message	`mEsIdZ
messenger	`mEs@ndZ@
metabolism	m@`tAb@lIz@m
metal	`mEtl
metamorphosis	mEt@`m@:f@s@s
metaphor	`mEt@f@, -f@:
meteor	`mi:ti:@, -@:
meteorite	`mi:ti:@ra:It
meteorologist	mi:ti:@`rOl@dZ@st
meter	`mi:t@
methadone	`mET@d@Un
metho	`mET@U
method	`mET@d
methodical	m@`TOdIk@l
methylated spirits	`mET@lEIt@d `spIr@ts
meticulous	mE`tIkj@l@s
metre	`mi:t@
metric	`mEtrIk
metropolitan	mEtr@`pOl@t@n
mezzanine	`mEz@ni:n, mEz@`ni:n
mg	
mice	ma:Is
microbe	`ma:Ikr@Ub
microphone	`ma:Ikr@f@Un
microscope	`ma:Ikr@sk@Up
microwave oven	ma:Ikr@wEIv `V v@n
mid	mId
midday	`mIddEI
middle	`mIdl
midget	`mIdZ@t
midnight	`mIdna:It
midriff	`mIdrIf
midwife	`mIdwa:If
mighty	`ma:Iti:
migraine	`ma:IgrEIn, `mi:grEIn
migrant	`ma:Igr@nt
migrate	`ma:IgrEIt, ma:I`grEIt
mild	ma:Ild
mildew	`mIldju:
mile	ma:Il
militant	`mIl@t@nt
military	`mIl@tri:, -t@ri:
militia	m@`lIS@
milk	mIlk
milk bar	`mIlk ba:
milkshake	`mIlkSEIk
mill	mIl
millennium	m@`lEni:@m
millibar	`mIli:ba:
milligram	`mIl@grAm
millilitre	`mIl@li:t@
millimetre	`mIl@mi:t@
milliner	`mIl@n@
million	`mIlj@n
mime	ma:Im
mimic	`mImIk
min.	
mince	mIns
mincemeat	`mInsmi:t
mind	ma:Ind
mindful	`ma:Indf@l
mindless	`ma:Indl@s
mine	ma:In
miner	`ma:In@
mineral	`mIn@r@l, `mInr@l
mineral water	`mIn@r@l w@:t@
mingle	`mINg@l
miniature	`mIn@tS@
minimal	`mIn@m@l
minimum	`mIn@m@m
minister	`mIn@st@
minor	`ma:In@
minority	ma:I`nOr@ti:, m@-
mint	mInt
minus	`ma:In@s
minute	ma:I`nju:t
miracle	`mIr@k@l
mirage	m@`ra:Z
mire	`ma:I@
mirror	`mIr@
mirth	m@:T
misadventure	mIs@d`vEntS@
misbehave	mIsb@`hEIv
miscarriage	mIs`kArIdZ, `mIskArIdZ
miscellaneous	mIs@`lEIni:@s
mischief	`mIstS@f
misdemeanour	mIsd@`mi:n@
miser	`ma:Iz@
miserable	`mIzr@b@l
misery	`mIz@ri:
misfortune	mIs`f@:tS@n
mishap	`mIshAp
mislay	mIs`lEI
mislead	mIs`li:d
miss	mIs
missile	`mIsa:Il
missing	`mIsIN
mission	`mIS@n
missionary	`mIS@nri:
mist	mIst
mistake	m@`stEIk
mistaken	m@`stEIk@n
mistress	`mIstr@s
misunderstand	mIsV nd@`stAnd
mitigate	`mIt@gEIt
mitten	`mItn
mix	mIks
mixed-up	`mIkst-V p
mixture	`mIkstS@
mix-up	`mIks-V p
ml	
mm	
mnemonic	n@`mOnIk
moan	m@Un
mob	mOb
mobile	`m@Uba:Il
mobilise	`m@Ub@la:Iz
mock	mOk
modal	`m@Udl
mode	m@Ud
model	`mOdl
moderate	`mOdr@t, -@r@t
modern	`mOdn
modest	`mOd@st
modify	`mOd@fa:I
module	`mOdZu:l
moist	m@:Ist
molar	`m@Ul@
mole	m@Ul
molecule	`mOl@kju:l
molest	m@`lEst
molten	`m@Ultn
moment	`m@Um@nt
momentary	`m@u:m@ntri:
momentous	m@`mEnt@s
monarch	`mOn@k, -a:k
monastery	`mOn@stri:
Monday	`mV ndEI
money	`mV ni:
mongrel	`mV Ngr@l
monitor	`mOn@t@
monk	mV Nk
monkey	`mV Nki:
mono	`mOn@U
monogamy	m@`nOg@mi:
monogram	`mOn@grAm
monolith	`mOn@lIT
monologue	`mOn@lOg
monopoly	m@`nOp@li:
monosodium glutamate	
monotonous	m@`nOt@n@s
monotreme	`mOn@tri:m
monsoon	mOn`su:n
monster	`mOnst@
monstrous	`mOnstr@s
month	mV nT
monument	`mOnj@m@nt
monumental	mOnj@`mEntl
mood	mu:d
moody	`mu:di:
moon	mu:n
moor	m@:, mU@
mooring	`m@:rIN, `mU@-
	mOp
mope	m@Up
moral	`mOr@l
morale	m@`ra:l
moratorium	mOr@`t@:ri:@m
morbid	`m@:b@d
more	m@:
moreover	m@:r`@Uv@
morgue	m@:g
mornay	`m@:nEI
morning	`m@:nIN
moron	`m@:rOn
morose	m@`r@Us
morphine	`m@:fi:n
morsel	`m@:s@l
mortal	`m@:tl
mortality	m@:`tAl@ti:
mortar	`m@:t@
mortgage	`m@:gIdZ
mortified	`m@:t@fa:Id
mortuary	`m@:tS@ri:
mosaic	m@`zEIIk
mosque	mOsk
moss	mOs
most	m@Ust
mostly	`m@Ustli:
motel	m@U`tEl
mother	`mV D@
mother-in-law	`mV D@r-@n-l@:
mother-of-pearl	mV D@r-@v-`p@:l
motif	m@U`ti:f
motion	`m@US@n
motivate	`m@Ut@vEIt
motive	`m@UtIv
motor	`m@Ut@
motorbike	`m@Ut@ba:Ik
motorcycle	`m@Ut@sa:Ik@l
motorist	`m@Ut@r@st
mottled	`mOtld
motto	`mOt@U
mould	m@Uld
moult	m@Ult
mound	ma:Und
mount	ma:Unt
mountain	`ma:Unt@n
mountaineer	ma:Unt@`nI@
mourn	m@:n
mouse	ma:Us
mousse	mu:s
moustache	m@`sta:S
mousy	`ma:Usi:
mouth	ma:UT
mouth-watering	`ma:UT-w@:t@rIN
move	mu:v
movement	`mu:vm@nt
movie	`mu:vi:
mow	m@U
MP	Em `pi:
Mr	`mIst@
Mrs	`mIs@z
Ms	mIz, m@z
MS	Em `Es
MSG	Em Es `dZi:
Mt	
much	mV tS
muck	mV k
mud	mV d
muddle	`mV dl
mudguard	`mV dga:d
muesli	`mju:zli:
muffin	`mV f@n
muffler	`mV fl@
mug	mV g
muggy	`mV gi:
mulch	mV ltS
mulga	`mV lg@
mull	mV l
multicultural	mV lti:`kV ltS@r@l
multimedia	mV lti:`mi:di:@
multinational	mV lti:`nAS@n@l
multiple	`mV lt@p@l
multiple-choice	`mV lt@pl-tS@:Is
multiple sclerosis	mV lt@p@l skl@`r@Us@s
multiply	`mV lt@pla:I
multiracial	mV lti:`rEIS@l
multitude	`mV lt@tSu:d
mum	mV m
mumble	`mV mb@l
mummy	`mV mi:
mumps	mV mps
munch	mV ntS
mundane	mV n`dEIn
municipality	mju:n@s@`pAl@ti:
mural	`mju:r@l
murder	`m@:d@
murky	`m@:ki:
murmur	`m@:m@
muscle	`mV s@l
museum	mju:`zi:@m
mush	mV S
mushroom	`mV Sru:m
music	`mju:zIk
musical	`mju:zIk@l
musk	mV sk
must	mV st
mustard	`mV st@d
muster	`mV st@
musty	`mV sti:
mutate	mju:`tEIt
mute	mju:t
mutilate	`mju:t@lEIt
mutiny	`mju:t@ni:
mutter	`mV t@
mutton	`mV tn
mutual	`mju:tSu:@l
muzzle	`mV z@l
my	ma:I
myopia	ma:I`@Upi:@
myriad	`mIri:@d
myself	ma:I`sElf, m@`sElf
mysterious	m@s`tI@ri:@s
mystery	`mIstri:, -t@ri:
mystic	`mIstIk
mystify	`mIst@fa:I
myth	mIT
mythology	m@`TOl@dZi:
N, n	En
N	
N/A	En `EI
nag	nAg
	nEIl
naive	na:I`i:v
naked	`nEIk@d
name	nEIm
nap	nAp
napkin	`nApk@n
	`nApi:
narcotic	na:`kOtIk
narration	n@`rEIS@n
narrative	`nAr@tv
narrow	`nAr@U
nasal	`nEIz@l
nasty	`na:sti:
nation	`nEIS@n
national	`nASn@l
nationalise	`nASn@la:Iz
nationalism	`nASn@lIzm
native	`nEItIv
natter	`nAt@
natty	`nAti:
natural	`nAtS@r@l
naturalised	`nAtS@r@la:Izd
nature	`nEItS@
naughty	`n@:ti:
nausea	`n@:si:@
navel	`nEIv@l
navigate	`nAv@gEIt
navy	`nEIvi:
NB	En `bi:
NE	n@:T`i:st
near	nI@
nearby	nI@`ba:I
nearly	`nI@li:
neat	ni:t
necessary	`nEs@s@ri:
neck	nEk
necklace	`nEkl@s
nee	nEI
need	ni:d
	`ni:dl
negative	`nEg@tIv
neglect	n@`glEkt
negligee	`nEgl@ZEI
negligent	`nEgl@dZ@nt
negligible	`nEgl@dZ@bl
negotiable	nE`g@USi:@bl
negotiate	n@`g@USi:;EIt
neighbour	`nEIb@
neither	`na:ID@, `ni:D@
nephew	`nEfju:, `nEvju:
nerd	n@:d
nerve	n@:v
nervous	`n@:v@s
nest	nEst
net	nEt
netball	`nEtb@:l
nettle	`nEtl
network	`nEtw@:k
neurotic	nju:`rOtIk
neuter	`nju:t@
neutral	`nju:tr@l
never	`nEv@
nevertheless	nEv@D@`lEs
new	nju:
news	nju:z
newspaper	`nju:zpEIp@
next	nEkst
next of kin	nEkst@v`kIn
	nIb
nibble	`nIbl
nice	na:Is
niche	ni:S
nick	nIk
nickname	`nIknEIm
nicotine	nIk@`ti:n
niece	ni:s
nifty	`nIfti:
night	na:It
nightclothes	`na:Itkl@UDz
nightdress	`na:ItdrEs
nightshirt	`na:ItS@:t
nightmare	`na:ItmE@
nil	nIl
nimble	`ni:mbl
nine	na:In
nineteen	na:In`ti:n
nineteenth	na:In`ti:nT
ninety	`na:Inti:
ninth	na:InT
nip	nIp
nippers	`nIp@z
nipple	`nIpl
nit	nIt
no	n@U
no.	`nV mb@
noble	`n@Ubl
nobody	`n@UbOdi:
nocturnal	nOk`t@:n@l
nod	nOd
nodule	`nOdju:l
noise	n@:Iz
nominate	`nOm@nEIt
nonchalant	`nOnS@l@nt
nondescript	`nOnd@skrIpt
none	nV n
nonentity	nOn`Ent@ti:
nonetheless	nV nD@`lEs
nonfiction	nOn`fIkS@n
nonflammable	nOn`flAm@bl
nonplussed	nOn`plV st
nonsense	`nOns@ns
noodle	`nu:d@l
noon	nu:n
no-one	`n@UwV n
noose	nu:s
nor	n@:
normal	`n@:m@l
north	n@:T
northward	`n@:Tw@d
nose	n@Uz
nostalgia	nOs`tAldZ@
nostril	`nOstr@l
not	nOt
notable	`n@Ut@bl
notch	nOtS
note	n@Ut
nothing	`nV TIN
notice	`n@Ut@s
notify	`n@Ut@fa:I
notion	`n@US@n
notorious	n@`t@:ri:@s
nought	n@:t
noun	na:Un
nourish	`nV rIS
Nov.	n@`vEmb@
novel	`nOv@l
novelty	`nOv@lti:
November	n@`vEmb@
now	na:U
noxious	`nOkS@s
	`nOzl
NSW	;nju: sa:UT `wEIlz
NT	;n@:D@n `tEr@tri:
nuclear	`nju:kli:@
nucleus	`nju:kli:@s
nude	nju:d
nudge	nV dZ
nugget	`nV g@t
nuisance	`nju:s@ns
numb	nV m
number	`nV m@
numberplate	`nV mb@plEIt
numeral	`nju:m@r@l
numerator	`nju:m@rEIt@
numerous	`nju:m@r@s
nun	nV n
nurse	n@:s
nursery	`n@:s@ri:
nut	nV t
nutrition	nju:`trIS@n
nutritionist	nju:`trIS@ni:st
NW	n@:T`wEst
nylon	`na:IlOn
O, o	@U
oaf	@Uf
oar	@:
oath	@UT
obedient	@`bi:di:@nt
obese	@U`bi:s
obey	@U`bEI
object	`ObdZEkt
objective	@b`dZEktIv
oblige	@`bla:IdZ
oblong	`OblON
obscene	@b`si:n, Ob-
obscure	@b`skju:@, -`skjU@
observe	@b`z@:v
obsession	@b`sES@n
obsolete	`Obs@li:t
obstacle	`Obst@k@l
obstetrician	Obst@`trIS@n
obstinate	`Obst@n@t
obstruct	@b`strV kt
obtain	@b`tEIn
obtuse	@b`tju:s, Ob-
obvious	`Obvi:@s
occasion	@`kEIZ@n
occasional	@`kEIZ@n@l
occupation	Okj@`pEIS@n
occupied	`Okj@pa:Id
occupy	`Okj@pa:I
occur	@`k@:
ocean	`@US@n
o'clock	@`klOk
Oct.	
October	Ok`t@Ub@
odd	Od
odious	`@Udi:@s
odour	`@Ud@
of	Ov
off	Of
off-colour	Of-`kV l@
offence	@`fEns
offensive	@`fEnsIv
offer	`Of@
office	`Of@s
officer	`Of@s@
official	@`fIS@l
off-peak	`Of-pi:k
off-putting	`Of-pUtIN
often	`Of@n, `Oft@n
oh	@U
oil	@:Il
ointment	`@:Intm@nt
OK	@U `kEI
okay	@U`kEI
old	@Uld
old age	@Uld `EIdZ
old-fashioned	@Uld-`fAS@nd
olive	`Ol@v, -lIv
Olympic Games	@lImpIk `gEImz
ombudsman	`Omb@dzm@n
omelette	`Oml@t
omen	`@Um@n
ominous	`Om@n@s
omit	@U`mIt, @-
on	On
once	wV ns
oncoming	`OnkV mIN
one	wV n
only	`@Unli:
onset	`OnsEt
onto	`Ont@
ooze	u:z
opal	`@Up@l
opaque	@U`pEIk
open	`@Up@n
open-minded	`@Up@n-ma:Ind@d
opera	`Opr@, `Op@r@
operate	`Op@rEIt
ophthalmologist	OfTAl`mOl@dZ@st
opinion	@`pInj@n
opponent	@`p@Un@nt
opportunity	Op@`tju:n@ti:
oppose	@`p@Uz
opposite	`Op@s@t
oppression	@`prES@n
optician	Op`tIS@n
optimism	`Opt@mIz@m
option	`OpS@n
optometrist	Op`tOm@tr@st
or	@:
oral	`Or@l
orange	`OrIndZ
orator	`Or@t@
orchard	`@:tS@d
orchestra	`@:k@str@
ordeal	@:`di:l, `@:di:l
order	`@:d@
ordinal number	@:d@n@l `nV mb@
ordinary	`@:d@n@ri:, `@:d@nri:
organ	`@:g@n
organic	@:`gAnIk
organisation	@:g@na:I`zEIS@n
organise	`@:g@na:Iz
organism	`@:g@nIz@m
orgasm	`@:gAz@m
orgy	`@:dZi:
oriental	@:ri:`Entl, Ori:-
origin	`Or@dZ@n
original	@`rIdZ@n@l
originate	@`rIdZ@nEIt
ornament	`@:n@m@nt
orphan	`@:f@n
orthodontist	@:T@`dOnt@st
orthodox	`@:T@dOks
orthopaedic surgeon	@:T@;pi:dIk `s@:dZ@n
osteopath	`Osti:@pAT
other	`V D@
otherwise	`V D@wa:Iz
ought	@:t
our	a:U@
ours	`a:U@z
ourselves	a:U@`sElvz
out	a:Ut
outback	`a:UtbAk
outbreak	`a:UtbrEIk
outburst	`a:Utb@:st
outcome	`a:UtkV m
outcry	`a:Utkra:I
outdoors	a:Ut`d@:z
outer	`a:Ut@
outfit	`a:UtfIt
outgoing	a:Ut`g@UIN
outing	`a:UtIN
outline	`a:Utla:In
outlook	`a:UtlUk
outpatient	`a:UtpEIS@nt
outrage	a:Ut`rEIdZ
outright	`a:Utra:It
outset	`a:UtsEt
outside	a:Ut`sa:Id
outskirts	`a:Utsk@:ts
outspoken	`a:Utsp@Uk@n
outstanding	a:Ut`stAndIN
outward	`a:Utw@d
outwards	`a:Utw@dz
outwit	a:Ut`wIt
	`@Uv@l
ovary	`@Uv@ri:
oven	`V v@n
over	`@Uv@
overalls	`@Uv@r@:lz
overarm	`@Uv@ra:m
overawe	@Uv@r`@:
overbalance	@Uv@`bAl@ns
overbearing	@Uv@`bE@rIN
overboard	`@Uv@b@:d
overcast	`@Uv@ka:st
overcoat	`@Uv@k@Ut
overcome	@Uv@`kV m
overdo	@Uv@`du:
overdose	`@Uv@d@Us
overdraft	`@Uv@dra:ft
overdue	@Uv@`dju:
overflow	@Uv@`fl@U
overhaul	`@Uv@h@:l
overhead	@Uv@`hEd
overhear	@Uv@`hI@
overlap	@Uv@`lAp
overlook	@Uv@`lUk
overnight	@Uv@`na:It
overpower	@Uv@`pa:U@
overrule	@Uv@`ru:l
overseas	@Uv@`si:z
oversight	`@Uv@sa:It
overtake	@Uv@`tEIk
overtime	`@Uv@ta:Im
overturn	@Uv@`t@:n
overweight	@Uv@`wEIt
overwhelm	@Uv@`wElmd
overwork	@Uv@`w@:k
ovulate	`@vj@lEIt
owe	@U
owl	a:Ul
own	@Un
oxygen	`Oks@dZ@n
oyster	`@:Ist@
P, p	pi:
P	
p.a.	p@:r`An@m
PA	pi: `EI
pace	pEIs
pacifist	`pAs@f@st
pacify	`pAs@fa:I
pack	pAk
package	`pAkIdZ
packaging	`pAkIdZIN
packed	pAkt
packet	`pAk@t
pact	pAkt
pad	pAd
paddle	`pAdl
paddock	`pAd@k
padlock	`pAdlOk
paediatrician	pi:di:@`trISn
page	pEIdZ
paid	pEId
paid-up	`pEId-V p, pEId `V p
pain	pEIn
painstaking	`pEInztEIkIN
paint	pEInt
painting	`pEIntIN
pair	pE@
pal	pAl
palace	`pAl@s
palate	pAl@t
pale	pEIl
palm	pa:m
palpitate	`pAlp@tEIt
paltry	`p@:ltri:
pamper	`pAmp@
pamphlet	`pAmfl@t
pan	pAn
pancake	`pANkEIk
pancreas	`pANkri:@s
pandemonium	pAnd@`m@Uni:@m
pander	`pAnd@
pane	pEIn
panel	`pAn@l
panel van	`pAn@l vAn
pang	pAN
panic	`pAnIk
panorama	pAn@`ra:m@
pant	pAnt
	`pAnti:h@Uz
pantomime	`pAnt@ma:Im
pantry	`pAntri:
pants	pAnts
paper	`pEIp@
paperback	`pEIp@bAk
Pap smear	`pAp smI@
par	pa:
parachute	`pAr@Su:t
parade	p@`rEId
paradise	`pAr@da:Is
paradox	`pAr@dOks
paragraph	`pAr@grAf, -gra:f
parallel	`pAr@lEl
paralyse	`pAr@la:Iz
paramedic	pAr@`mEdIk
paramount	`pAr@ma:Unt
paranoia	pAr@`n@:I@
paraphernalia	pAr@f@`nEIlj@
paraphrase	`pAr@frEIz
paraplegic	pAr@`pli:dZIk
parasite	`pAr@sa:It
parcel	`pa:s@l
pardon	`pa:dn
parent	`pE@r@nt
parish	`pArIS
park	pa:k
parka	`pa:k@
parliament	`pa:l@m@nt
parody	`pAr@di:
parole	p@`r@Ul
parquet	`pa:kEI
parrot	`pAr@t
parry	`pAri:
parsley	`pa:sli:
part	pa:t
partial	`pa:S@l
participate	p@`tIs@pEIt
participle	`pa:t@sIp@l
particle	`pa:tIk@l
particular	p@`tIkj@l@
partition	p@`tIS@n, pa:-
partner	`pa:tn@
part-time	pa:t-`ta:Im
party	`pa:ti:
pass	pa:s
passage	`pAsIdZ
passenger	`pAs@ndZ@
passion	`pAS@n
passionfruit	`pAS@nfru:t
passive	`pAsIv
passport	`pa:sp@:t
password	`pa:sw@:d
past	pa:st
pasta	`pAst@, `pa:s-
paste	pEIst
pastel	`pAstl
pasteurise	`pa:stS@ra:Iz
pastime	
pastry	`pEIstri:
pasture	`pa:stS@
pasty	`pEIsti:
pat	pAt
patch	pAtS
patent	`pEItnt
paternal	p@`t@:n@l
paternity	p@`t@:n@ti:
path	pa:T
pathetic	p@`TEtIk
pathology	p@`TOl@dZi:
patient	`pEIS@nt
patio	`pAti:@U, `pEISi:@U
patriarch	`pEItri:a:k, `pAt-
patriot	`pEItri:@t, pAt-
patrol	p@`tr@Ul
patron	`pEItr@n
patronise	`pAtr@na:Iz
patter	`pAt@
pattern	`pAtn
pause	p@:z
pave	pEIv
pavement	`pEIvm@nt
pavilion	p@`vIlj@n
pavlova	pAv`l@Uv@
paw	p@:
pawn	p@:n
pay	pEI
PAYE	pi: EI wa:I `i:, pEI
payroll	`pEIr@Ul
P & C	`pi: @n si:
Pde	
pea	pi:
peace	pi:s
peach	pi:tS
peak	pi:k
peal	pi:l
pearl	p@:l
peasant	`pEz@nt
peat	pi:t
pebble	`pEb@l
peck	pEk
peckish	`pEkIS
peculiar	p@`kju:li:@, -lj@
pedal	`pEdl
pedantic	p@`dAntIk
peddle	`pEdl
pedestal	`pEd@stl
pedestrian	p@`dEstri:@n
pee	pi:
peek	pi:k
peel	pi:l
peep	pi:p
peer	pI@
peeve	pi:v
peevish	`pi:vIS
peg	pEg
pelt	pElt
pelvis	`pElv@s
pen	pEn
penal	`pi:n@l
penalise	`pi:n@la:Iz
penalty	`pEn@lti:
pencil	`pEns@l
pendant	`pEnd@nt
penetrate	`pEn@trEIt
penfriend	`pEnfrEnd
penguin	`pENgw@n
penicillin	pEn@`sIl@n
peninsula	p@`nInS@l@
penis	`pi:n@s
penknife	`pEnna:If
penny	`pEni:
pension	`pEnS@n
pentathlon	pEn`tATl@n
penthouse	`pEntha:Us
people	`pi:p@l
pepper	`pEp@
peppermint	`pEp@m@nt
per	p@:
perceive	p@`si:v
per cent	p@ `sEnt
perception	p@`sEpS@n
perch	p@:tS
percolate	`p@:k@lEIt
perfect	`p@:fEkt
perform	p@`f@:m
perfume	`p@:fju:m
pergola	p@`g@Ul@, `p@:g@l@
perhaps	p@`hAps
peril	`pEr@l
period	`pI@ri:@d
periodical	pI@ri:`OdIk@l
peripheral	p@`rIf@r@l
perish	`pErIS
perishable	`pErIS@b@l
perjure	`p@:dZ@
perk	p@:k
permanent	`p@:m@n@nt
permission	p@`mIS@n
permit	p@`mIt
perpetrate	`p@:p@trEIt
perpetual	p@`pEtSu:@l
persecute	`p@:s@kju:t
persevere	
Persian	`p@:Z@n
persist	p@`sIst
person	`p@:s@n
personal	`p@:s@n@l
personality	p@:s@`nAl@ti:
personify	p@`sOn@fa:I
personnel	p@:s@`nEl
perspire	p@`spa:I@
persuade	p@`swEId
pert	p@:t
pertinent	`p@:t@n@nt
perturb	p@`t@:b
perverse	p@`v@:s
pervert	`p@:v@:t
pessimism	`pEs@mIz@m
pest	pEst
pester	`pEst@
pet	pEt
petal	`pEtl
peter out	pi:t@ `a:Ut
petite	p@`ti:t
petition	p@`tIS@n
petrify	`pEtr@fa:I
petrol	`pEtr@l
petroleum	p@`tr@Uli:@m
petticoat	`pEti:k@Ut
petty	`pEti:
petulant	`pEtS@l@nt
pewter	`pju:t@
phantom	`fAnt@m
pharmacist	`fa:m@s@st
phase	fEIz
phenomenal	f@`nOm@n@l
phenomenon	f@`nOm@n@n
phew	fju:
philosophy	f@`lOs@fi:
phlegm	flEm
phlegmatic	flEg`mAtIk
phobia	`f@Ubi:@
phone	f@Un
phonetics	f@`nEtIks
phoney	`f@Uni:
photo	`f@Ut@U
photocopy	`f@Ut@U`kOpi:
photogenic	f@Ut@`dZi:nIk
photograph	`f@Ut@grAf, -gra:f
phrase	frEIz
physical	`fIzIk@l
physician	f@`zIS@n
physics	`fIzIks
physiology	fIzi:`Ol@dZi:
physiotherapist	fIzi:@U`TEr@p@st
physique	f@`zi:k
piano	pi:`An@U
pick	pIk
picket	`pIk@t
pickle	`pIk@l
pickpocket	`pIkpOk@t
picnic	`pIknIk
pictorial	pIk`t@:ri:@l
picture	`pIktS@
pidgin	`pIdZ@n
	pa:I
piece	pi:s
pier	pI@
pierce	pI@s
pig	pIg
pig-headed	pIg-`hEd@d
pigment	`pIgm@nt
pigsty	`pIgsta:I
pile	pa:Il
pile-up	`pa:Il-V p
pilfer	`pIlf@
pilgrim	`pIlgr@m
Pilipino	pIl@`pi:n@U
pill	pIl
pillar	`pIl@
pillow	`pIl@U
pillowcase	`pIl@UkEIs
pilot	`pa:Il@t
pimple	`pImp@l
	pIn
PIN	pIn
pinch	pIntS
pine	pa:In
ping-pong	`pINpON
pink	pINk
pin-up	`pIn-V p
pioneer	pa:I@`nI@
pious	`pa:I@s
pip	pIp
pipe	pa:Ip
pirate	`pa:Ir@t
pistol	`pIstl
piston	`pIst@n
pit	pIt
pitch	pItS
pitch-dark	`pItS-da:k
pitfall	`pItf@:l
pith	pIT
pitiful	`pIt@f@l
pittance	`pItns
pity	`pIti:
pivot	`pIv@t
Pl	
placate	pl@`kEIt
place	plEIs
placid	`plAs@d
plague	plEIg
plain	plEIn
	plAt
plan	plAn
plane	plEIn
planet	`plAn@t
plank	plANk
plant	plAnt
plaque	pla:k
plaster	`pla:st@
plastered	`pla:st@d
plastic	`plAstIk
plastic surgery	plAstIk `s@:dZ@ri:
plate	plEIt
plateau	`plAt@U
platform	`plAtf@:m
platter	`plAt@
platypus	`plAt@pUs
plausible	`pl@:z@b@l
play	plEI
playground	`plEIgra:Und
playwright	`plEIra:It
plea	pli:
plead	pli:d
pleasant	`plEz@nt
please	pli:z
pleasure	`plEZ@
	pli:t
pledge	plEdZ
plenty	`plEnti:
pliable	`pla:I@b@l
	`pla:I@z
plight	pla:It
plod	plOd
plonk	plONk
plot	plOt
plough	pla:U
ploy	pl@:I
pluck	plV k
plucky	`plV ki:
plug	plV g
plughole	`plV gh@Ul
plumber	`plV m@
plummet	`plV m@t
plump	plV mp
plunge	plV ndZ
plural	`plU@r@l
plus	plV s
plush	plV S
ply	pla:I
plywood	`pla:IwUd
p.m.	pi: `Em
pneumonia	nju:`m@Unj@
PO	pi: `@U
poach	p@UtS
pocket	`pOk@t
pocket money	`pOk@t mV ni:
pod	pOd
podgy	`pOdZi:
poem	`p@U@m
poetry	`p@U@tri:
point	p@:Int
point-blank	p@:Int-`blANk
pointless	`p@:Intl@s
poise	p@:Iz
poison	`p@:Iz@n
poke	p@Uk
poker	`p@Uk@
poky	`p@Uki:
pole	p@Ul
police	p@`li:s
policy	`pOl@si:
polio	`p@Uli:@U
polish	`pOlIS
Polish	`p@UlIS
polite	p@`la:It
politician	pOl@`tIS@n
politics	`pOl@tIks
poll	p@U
pollen	`pOl@n
pollute	p@`lu:t
polo	`p@Ul@U
pommy	`pOmi:
pompous	`pOmp@s
pond	pOnd
ponder	`pOnd@
pong	pON
pony	`p@Uni:
ponytail	`p@Uni:tEIl
poo	pu:
pooh	pu:
pool	pu:l
poor	p@:
pop	pOp
Pope	p@Up
popular	`pOpj@l@
populate	`pOpj@lEIt
porch	p@:tS
pore	p@:
pork	p@:k
pornography	p@:`nOgr@fi:
porous	`p@:r@s
porridge	`pOrIdZ
port	p@:t
portable	`p@:t@bl
porter	`p@:t@
portfolio	p@:t`f@Uli:@U
portion	`p@:S@n
portrait	`p@:tr@t
portray	p@:`trEI
Portuguese	p@:tS@`gi:z
pose	p@Uz
posh	pOS
position	p@`zIS@n
positive	`pOz@tIv
possess	p@`zEs
possession	p@`zES@n
possessive	p@`zEsIv
possible	`pOs@b@l
possum	`pOs@m
post	p@Ust
postal label	`p@Ustl lEIb@l
postbox	`p@UstbOks
postcard	`p@Ustka:d
postcode	`p@Ustk@Ud
poster	`p@Ust@
posterior	pO`stI@ri:@
posterity	pO`stEr@ti:
postgraduate	p@Ust`grAdZu:@t
postman	`p@Ustm@n
post-mortem	p@Ust-`m@:t@m
post office	`p@Ust Of@s
post-office box	`p@Ust-Of@s bOks
postpone	p@Ust`p@Un, p@Us`p@Un
postscript	`p@UstskrIpt
posture	`pOstS@
posy	`p@u:zi:
pot	pOt
potato	p@`tEIt@U
potent	`p@Utnt
potential	p@`tEnS@l
pothole	`pOth@Ul
potter	`pOt@
potty	`pOti:
	pa:UtS
poultry	`p@Ultri:
pounce	pa:Uns
pound	pa:Und
pour	p@:
pout	pa:Ut
poverty	`pOv@ti:
powder	`pa:Ud@
power	`pa:U@
	
P-plate	`pi:-plEIt
practical	`prAktIk@l
practically	`prAktIkli:
practice	`prAkt@s
practise	`prAkt@s
praise	prEIz
pram	prAm
prance	prAns, pra:ns
prank	pra:Nk
prattle	`prAtl
pray	prEI
preach	pri:tS
precarious	pr@`kE@ri:@s
precaution	pr@`k@:S@n
precede	pri:`si:d
precedent	`pri:s@d@nt, `prE-
precious	`prES@s
precipice	`prEs@p@s
precis	`prEIsi:
precise	pr@`sa:Is
precocious	prE`k@US@s
predecessor	`pri:d@sEs@
predicament	pr@`dIk@m@nt
predict	pr@`dIkt
predictable	pr@`dIkt@b@l
predominant	pr@`dOm@n@nt
preen	pri:n
preface	`prEf@s
prefect	`pri:fEkt
prefer	pr@`f@:
prefix	`pri:fIks
pregnant	`prEgn@nt
prejudice	`prEdZ@d@s
preliminary	pr@`lIm@nri:
prelude	`prElju:d
premature	`prEm@tS@, prEm@`tSu:@
premier	`prEmi:@
premiere	prEmi:`E@
premise	`prEm@s
premium	`pri:mi:@m
premonition	`prEm@nIS@n
preoccupied	pri:`Okj@pa:Id
prepare	pr@`pE@
preposition	prEp@`zIS@n
preposterous	pr@`pOstr@s
prescribe	pr@`skra:Ib
prescription	pr@`skrIpS@n
present	`prEz@nt
presentable	pr@`zEnt@b@l
presently	`prEz@ntli:
preserve	pr@`z@:v
president	`prEz@d@nt
press	prEs
press-up	`prEs-V p
pressure	`prES@
prestige	prEs`ti:Z
presume	pr@`zju:m
pretend	pr@`tEnd
pretty	`prIti:
prevalent	`prEv@l@nt
prevaricate	pr@`vAr@kEIt
prevent	pr@`vEnt
preview	`pri:vju:
previous	`pri:vi:@s
prey	prEI
price	pra:Is
priceless	`pra:Isl@s
pricey	`pra:Isi:
prick	prIk
pride	pra:Id
priest	pri:st
prig	prIg
prim	prIm
primary	`pra:Im@ri:, `pra:Imri:
primary school	`pra:Imri: sku:l
prime	pra:Im
prime minister	pra:Im `mIn@st@
prime number	pra:Im `nV mb@
primitive	`prIm@tIv
prince	prIns
princess	`prInsEs
principal	`prIns@p@l
principle	`prIns@p@l
print	prInt
printer	`prInt@
prior	`pra:I@
priority	pra:I`Or@ti:
prise	pra:Iz
prism	`prIzm
prison	`prIz@n
private	`pra:Iv@t
privilege	`prIv@lIdZ
prize	pra:Iz
probable	`prOb@b@l
probe	pr@Ub
problem	`prObl@m
procedure	pr@`si:dZ@
proceed	pr@`si:d
process	`pr@UsEs
prod	prOd
prodigy	`prOd@dZi:
produce	pr@`dju:s
product	`prOdV kt
productive	pr@`dV ktIv
profession	pr@`fES@n
professor	pr@`fEs@
proficient	pr@`fIS@nt
profile	`pr@Ufa:Il
profit	`prOf@t
profound	pr@`fa:Und
program	
programme	`pr@UgrAm
progress	`pr@UgrEs
progressive	pr@`grEsIv
prohibit	pr@`hIb@t
project	`pr@UdZEkt, `prO
prologue	`pr@UlOg
prolong	pr@`lON
promenade	prOm@`na:d
prominent	`prOm@n@nt
promise	`prOm@s
promote	pr@`m@Ut
prompt	prOmpt
prone	pr@Un
	prON
pronoun	`pr@Una:Un
pronounce	pr@`na:Uns
pronounced	pr@`na:Unst
proof	pru:f
prop	prOp
propaganda	prOp@`gAnd@
propel	pr@`pEl
proper	`prOp@
property	`prOp@ti:
proportion	pr@`p@:S@n
propose	pr@`p@Uz
proprietary limited company	
proprietor	pr@`pra:I@t@
pro rata	pr@U `ra:t@
prose	pr@Uz
prosecute	`prOs@kju:t
prospect	`prOspEkt
prospectus	pr@`spEkt@s
prosper	`prOsp@
prostitute	`prOst@tju:t
protect	pr@`tEkt
protective	pr@`tEktIv
protein	`pr@Uti:n
protest	pr@`tEst, `pr@UtEst
Protestant	`prOt@st@nt
protocol	`pr@Ut@kOl
prototype	`pr@Ut@ta:Ip
protracted	pr@`trAkt@d
proud	pra:Ud
prove	pru:v
provide	pr@`va:Id
provision	pr@`vIZ@n
provisional	pr@`vIZ@n@l
provoke	pr@`v@Uk
prowl	pra:Ul
proxy	`prOksi:
prudent	`pru:d@nt
prune	pru:n
pry	pra:I
PS	pi: `Es
pseudonym	`sju:d@nIm
psych	sa:Ik
psyche	`sa:Iki:
psychiatrist	s@`ka:I@tr@st, sa:I-
psychic	`sa:IkIk
psycho	`sa:Ik@U
psychoanalyst	sa:Ik@U`An@l@st
psychology	sa:I`kOl@dZi:
p.t.o.	pi: ti: `@U
Pty Ltd	
pub	pV b
puberty	`pju:b@ti:
pubic	`pju:bIk
public	`pV blIk
public relations	pV blIk r@`lEISnz
public school	pV blIk `sku:l
public service	pV blIk `s@:v@s
public servant	pV blIk `s@:v@nt
publican	`pV blIk@n
publication	pV bl@`kEIS@n
publicity	pV b`lIs@ti:
publish	`pV blIS
pucker	`pV k@
pudding	`pUdIN
puddle	`pV dl
puff	pV f
pugnacious	pV g`nEIS@s
pull	pUl
pullover	`pUl@Uv@
pulp	pV lp
pulse	pV ls
pump	pV mp
	
pumpkin	`pV mpk@n
pun	pV n
punch	pV ntS
punctual	`pV NktSu:@l
punctuation	pV NktSu:`EIS@n
puncture	`pV NktS@
punish	`pV nIS
punt	pV nt
puny	`pju:ni:
pup	pV p
pupil	`pju:p@l
puppet	`pV p@t
purchase	`p@:tS@s
pure	`pju:@, pjU@, pj@:
puree	`pju:rEI
purge	p@:dZ
purple	`p@:p@l
purpose	`p@:p@s
purr	p@:
purse	p@:s
pursue	p@`sju:
pus	pV s
push	pUS
pushed	pUSt
pusher	`pUS@
pushover	`pUS@Uv@
push-up	`pUS-V p
put	pUt
putty	`pV ti:
puzzle	`pV z@l
pyjamas	p@`dZa:m@z
pylon	`pa:IlOn
pyramid	`pIr@mId
python	`pa:IT@n
Q, q	kju:
QC	kju: `si:
Qld	`kwi:nzl@nd, -lAnd
quack	kwAk
quadrangle	`kwOdrANg@l
quadriplegic	kwOdr@`pli:dZIk
quadruped	`kwOdr@pEd
quadruple	kw@`dru:p@l, `kwOdr@p@l
quadruplet	kwO`dru:pl@t
quaint	kwEInt
quake	kwEIk
qualify	`kwOl@fa:I
quality	`kwOl@ti:
quantity	`kwOnt@ti:
quarantine	`kwOr@nti:n
quarrel	`kwOr@l
quarry	`kwOri:
quarter	`kw@:t@
quartet	kw@:`tEt
quay	ki:
queen	kwi:n
queer	`kwI@
query	`kwI@ri:
quest	kwEst
question	`kwEstS@n
questionnaire	kwEstS@n`E@
queue	kju:
quibble	`kwIb@l
quiche	ki:S
quick	kwIk
quicksand	`kwIksAnd
quiet	`kwa:I@t
quilt	kwIlt
quinine	`kwIni:n, kw@`ni:n
quip	kwIp
quit	kwIt
quite	kwa:It
quiz	kwIz
quorum	`kw@:r@m
quota	`kw@Ut@
quotation	kw@U`tEIS@n
quotation marks	kw@U`tEIS@n ma:ks
quote	kw@Ut
R, r	a:
rabbi	`rAba:I
rabble	`rAb@l
race	rEIs
racecourse	`rEIsk@:s
racist	`rEIs@st
rack	rAk
racket	`rAk@t
racquet	`rAk@t
radar	`rEIda:
radiation	rEIdi:`EIS@n
radiator	`rEIdi:EIt@
radical	`rAdIk@l
radio	`rEIdi:@U
radioactive	rEIdi:@U`AktIv
radiography	rEIdi:`Ogr@fi:
radiologist	rEIdi:`Ol@dZ@st
radiotherapy	rEIdi:@U`TEr@pi:
radish	`rAdIS
	`rEIdi:@s
raffle	`rAf@l
rafter	`ra:ft@
rag	rAg
rage	rEIdZ
ragged	`rAg@d
raid	rEId
rail	rEIl
railing	`rEIlIN
railway	`rEIlwEI
rain	rEIn
rainbow	`rEInb@U
rainforest	`rEInfOr@st
raise	rEIz
raisin	`rEIz@n
	rEIk
rally	`rAli:
ram	rAm
RAM	rAm
ramble	`rAmb@l
	rAmp
ramshackle	`rAmSAk@l
ran	rAn
random	`rAnd@m
rang	rAN
range	rEIndZ
ranger	`rEIndZ@
rank	rANk
ransack	`rAnsAk
ransom	`rAns@m
rape	rEIp
rapid	`rAp@d
rare	rE@
rash	rAS
rasher	`rAS@
rat	rAt
rate	rEIt
rather	`ra:D@
ratio	`rEISi:@U
ration	`rAS@n
ratshit	`rAtSIt
rattle	`rAtl
rave	rEIv
ravenous	`rAv@n@s
ravine	r@`vi:n
ravishing	`rAv@SIN
raw	r@:
ray	rEI
razor	`rEIz@
Rd	
re	ri:, rEI
reach	ri:tS
react	ri:`Akt
read	ri:d
ready	`rEdi:
real	ri:l
real estate	`ri:l @stEIt
realise	`ri:@la:Iz
realist	`ri:@l@st
reality	ri:`Al@ti:
really	`rI@li:
realty	`ri:@lti:
rear	`rI@
reason	`ri:z@n
reasonable	`ri:z@n@b@l
rebate	`ri:bEIt
rebel	`rEb@l
recall	`r@k@:l
recede	r@`si:d
receipt	r@`si:t
receive	r@`si:v
receiver	r@`si:v@
recent	`ri:s@nt
receptacle	r@`sEpt@k@l
reception	r@`sEpS@n
receptionist	r@`sEpS@n@st
recess	r@`sEs, `ri:sEs
recession	r@`sES@n
recipe	`rEs@pi:
recipient	r@`sIpi:@nt
recital	r@`sa:It@l
recite	r@`sa:It
reckless	`rEkl@s
reckon	`rEk@n
recognise	`rEk@gna:Iz
recoil	r@`k@:Il
recollect	rEk@`lEkt
recommend	rEk@`mEnd
reconcile	`rEk@nsa:Il
record	r@`k@:d
recorder	r@`k@:d@
record-player	`rEk@:d-plEI@
recount	r@`ka:Unt
re-count	`ri:-ka:Unt
recover	r@`kV v@
recreation	rEkri:`EIS@n
recruit	r@`kru:t
	`rEktANg@l
rectum	`rEkt@m
recuperate	r@`ku:p@rEIt
recur	r@`k@:
recycle	ri:`sa:Ik@l
red	rEd
red-back	`rEd-bAk
redeem	r@`di:m
red tape	rEd `tEIp
reduce	r@`dju:s
redundant	r@`dV nd@nt
reef	ri:f
	ri:l
refer	r@`f@:
referee	rEf@`ri:
reference	`rEfr@ns
referendum	rEf@`rEnd@m
reflect	r@`flEkt
reflex	`ri:flEks
reflexive pronoun	r@flEksIv `pr@Una:Un
reform	r@`f@:m
refrain	r@`frEIn
refresh	r@`frES
refreshments	r@`frESm@nts
refrigerator	r@`frIdZ@rEIt@
refuge	`rEfju:dZ
refugee	rEfju:`dZi:
refund	`ri:fV nd
refuse	r@`fju:z
regain	r@`gEIn
regard	r@`ga:d
regardless	r@`ga:dl@s
regime	rEI`Zi:m
region	`ri:dZ@n
register	`rEdZ@st@
registry	`rEdZ@stri:
registry office	`rEdZ@stri: Of@s
rego	`rEdZ@U
regret	r@`grEt
regular	`rEgj@l@
regulate	`rEgj@lEIt
regulation	rEgj@`lEIS@n
rehabilitate	ri:h@`bIl@tEIt
rehearse	r@`h@:s
reign	rEIn
reimburse	ri:Im`b@:s
rein	rEIn
reincarnation	ri:Inka:`nEIS@n
reinforce	ri:In`f@:s
reinforcements	ri:In`f@:sm@nts
reinstate	ri:In`stEIt
reject	r@`dZEkt
rejoice	r@`dZ@:Is
relapse	r@`lAps, `ri:lAps
relate	r@`lEIt
relation	r@`lEIS@n
relationship	r@`lEIS@nSIp
relative	`rEl@tIv
relatively	`rEl@tIvli:
relative pronoun	rEl@tIv `pr@Una:Un
relax	r@`lAks
relay	`ri:lEI
release	r@`lIs
relent	r@`lEnt
relentless	r@`lEntl@s
relevant	`rEl@v@nt
reliable	r@`la:I@b@l
reliant	r@`la:I@nt
relic	`rElIk
relief	r@`li:f
relieve	r@`li:v
religion	r@`lIdZ@n
reluctant	r@`lV kt@nt
rely	r@`la:I
remain	r@`mEIn
remainder	r@`mEInd@
remark	r@`ma:k
remarkable	r@`ma:k@b@l
remarry	ri:`mAri:
remedy	`rEm@di:
remember	r@`mEmb@
remind	r@`ma:Ind
remittance	r@`mIt@ns
remnant	`rEmn@nt
remote	r@`m@Ut
removalist	r@`mu:v@l@st
remove	r@`mu:v
renal	`ri:n@l
renew	r@`nju:
renounce	r@`na:Uns
renovate	`rEn@vEIt
rent	rEnt
rental	`rEnt@l
repair	r@`pE@
repay	ri:`pEI
repayment	r@`pEIm@nt
repeat	r@`pi:t
repeated	r@`pi:t@d
repel	r@`pEl
repellent	r@`pEl@nt
repent	r@`pEnt
replace	r@`plEIs
replay	`ri:plEI
replica	`rEplIk@
reply	r@`pla:I
report	r@`p@:t
reporter	r@`p@:t@
repossess	ri:p@`zEs
represent	rEpr@`zEnt
representative	rEpr@`zEnt@tIv
reprieve	r@`pri:v
reprimand	`rEpr@ma:nd, -mAnd
reprint	ri:`prInt
reproach	r@`pr@UtS
reproduce	ri:pr@`dju:s
reptile	`rEpta:Il
republic	r@`pV blIk
repugnant	r@`pV gn@nt
repulsive	r@`pV lsIv
reputable	`rEpj@t@b@l
reputation	rEpj@`tEIS@n
reputed	r@`pju:t@d
request	r@`kwEst
require	r@`kwa:I@
rescue	`rEskju:
research	r@`s@:tS, `ri:s@:tS
resemble	r@`zEmbl
resent	r@`zEnt
reservation	rEz@`vEISn
reserve	r@`z@:v
reserved	r@`z@:vd
reserve price	r@`z@:v pra:Is
reservoir	`rEz@vwa:
residence	`rEz@d@ns
resident	`rEz@d@nt
residential	rEz@`dEnSl
residue	`rEz@dju:
resign	r@`za:In
resist	r@`zIst
resistant	r@`zIst@nt
resolute	`rEz@lu:t
resolution	rEz@`lu:Sn
resolve	r@`zOlv
resort	r@`z@:t
resource	r@`z@:s
resourceful	r@`z@:sfUl
respect	r@`spEkt
respectable	r@`spEkt@bl
respectively	r@`spEktIvli:
respiration	rEsp@`rEISn
respond	r@`spOnd
rest	rEst
restaurant	`rEst@rOnt
restless	`rEstl@s
restore	r@`st@:
restrain	r@`strEIn
restrained	r@`strEInd
restrict	r@`strIkt
result	r@`zV lt
resume	r@`zju:m
resum;aae	
resurrect	rEz@`rEkt
resuscitate	r@`sV s@tEIt
retail	`ri:tEIl
retain	r@`tEIn
retaliate	r@`tAli:EIt
retire	r@`ta:I@
retrace	ri:`trEIs
retreat	r@`tri:t
retrench	r@`trEntS
retrieve	r@`tri:v
retrospective	rEtr@`spEktIv
return	r@`t@:n
reunion	ri:`ju:nj@n
reveal	r@`vi:l
revel	`rEv@l
revenge	r@`vEndZ
revenue	`rEv@nju:
Reverend	`rEvr@nd
reverent	`rEvr@nt
reverse	r@`v@:s
revert	r@`v@:t
review	r@`vju:
revise	r@`va:Iz
revive	r@`va:Iv
revolt	r@`v@Ult
revolution	rEv@`lu:Sn
revolutionary	rEv@`lu:S@nri:
revolve	r@`vOlv
revolver	r@`vOlv@
reward	r@`w@:d
rewarding	r@`w@:dIN
rheumatism	`ru:m@tIz@m
rhyme	ra:Im
rhythm	`rID@m
rib	rIb
ribbon	`rIb@n
rice	ra:Is
rich	rItS
rid	rId
riddle	`rIdl
ride	ra:Id
ridge	rIdZ
ridicule	`rId@kju:l
ridiculous	r@`dIkj@l@s
rifle	`ra:If@l
rift	rIft
rig	rIg
right	ra:It
rightful	`ra:Itf@l
rigid	`rIdZ@d
rim	rIm
rind	ra:Ind
ring	rIN
ring-in	`rIN-In
ringworm	`rINw@:m
rinse	rIns
riot	`ra:I@t
rip	rIp
ripcord	`rIpk@:d
ripe	ra:Ip
ripple	`rIp@l
rise	ra:Iz
risk	rIsk
rival	`ra:Iv@l
river	`rIv@
road	r@Ud
roadway	`r@UdwEI
roadworks	`r@Udw@:ks
roam	r@Um
roar	r@:
	r@Ust
rob	rOb
robbery	`rOb@ri:
robe	r@Ub
robot	`r@UbOt
robust	`r@UbV st, r@`bV st
rock	rOk
rockery	`rOk@ri:
rocket	`rOk@t
rod	rOd
rode	r@Ud
rogue	r@Ug
role	r@Ul
roll	r@Ul
roller-skate	`r@Ul@-skEIt
ROM	rOm
Roman	`r@Um@n
Romanian	r@U`mEIni:@n
romance	r@`mAns, `r@UmAns
romp	rOmp
roof	ru:f
room	ru:m
rooster	`ru:st@
root	ru:t
rope	r@Up
ropeable	`r@Up@bl
rort	r@:t
rose	r@Uz
roster	`rOst@
rosy	`r@Uzi:
rot	rOt
rotate	r@U`tEIt
rotten	`rOt@n
rough	rV f
roughage	`rV fIdZ
roulette	ru:`lEt
round	ra:Und
roundabout	`ra:Und@ba:Ut
rouse	ra:Uz
route	ru:t
routine	ru:`ti:n
row	r@U
rowdy	`ra:Udi:
royal	`r@:I@l
royalty	`r@:I@lti:
RSL	a:r Es `El
RSVP	a:r Es vi: `pi:
rub	rV b
rubber	`rV b@
rubbish	`rV bIS
rubble	`rV b@l
rubella	ru:`bEl@
ruby	`ru:bi:
rucksack	`rV ksAk
rudder	`rV d@
ruddy	`rV di:
rude	ru:d
ruffian	`rV fi:@n
rug	rV g
rugby	`rV gbi:
rugged	`rV g@d
ruin	`ru:@n
rule	ru:l
ruler	`ru:l@
rum	rV m
rumble	`rV mb@l
rummage	`rV mIdZ
rumour	`ru:m@
rump	rV mp
rumple	`rV mp@l
rumpus	`rV mp@s
run	rV n
run-down	rV n-`da:Un
rung	rV N
runner-up	rV n@r-`V p
runny	`rV ni:
runt	rV nt
runway	`rV nwEI
rupture	`rV ptS@
rural	`rU@r@l
rush	rV S
rust	rV st
rut	rV t
ruthless	`ru:Tl@s
S, s	Es
S	
-s	
's	
SA	sa:UT @`strEIlj@
Sabbath	`sAb@T
Sabin vaccine	`sEIb@n vAksi:n
sabotage	`sAb@ta:Z
saccharin	`sAk@r@n, -kr@n
sachet	`sASEI
	sAk
sacrament	`sAkr@m@nt
sacred	`sEIkr@d
sacrifice	`sAkr@fa:Is
sacrilege	`sAkr@lIdZ
sad	sAd
saddle	`sAdl
safari	s@`fa:ri:
safe	sEIf
sag	sAg
saga	`sa:g@
sage	sEIdZ
said	sEd
sail	sEIl
sailor	`sEIl@
saint	sEInt
sake	sEIk
salad	`sAl@d
salami	s@`la:mi:
salary	`sAl@ri:
sale	sEIl
salesperson	`sEIlzp@:sn
sales tax	`sEIlz tAks
saline	`sEIla:In, -li:n
saliva	s@`la:Iv@
sallow	`sAl@U
salon	`sAlOn
saloon	s@`lu:n
salt	sOlt, s@:lt
salute	s@`lu:t
salvage	`sAlvIdZ
salvation	sAl`vEIS@n
same	sEIm
sample	`sAmp@l
sanatorium	sAn@`t@:ri:@m
sanction	`sANkS@n
sand	sAnd
sandal	`sAndl
sandpaper	`sAndpEIp@
sandwich	`sAnwItS, -wIdZ
sane	sEIn
sang	sAN
sanitary	sAn@tri:
sank	sANk
sap	sAp
sapphire	`sAfa:I@
sarcasm	`sa:kAz@m
sardine	sa:`di:n
sari	`sa:ri:
sarong	s@`rON
sash	sAS
sat	sAt
satchel	`sAtS@l
satellite	`sAt@la:It
satin	`sAtn
satire	`sAta:I@
satisfactory	sAt@s`fAktri:
satisfy	`sAt@sfa:I
saturate	`sAtS@rEIt
Saturday	`sAt@dEI
sauce	s@:s
saucepan	`s@:sp@n
saucer	`s@:s@
sauna	`s@:n@
saunter	`s@:nt@
sausage	`sOsIdZ
saute	`s@UtEI
savage	`sAvIdZ
save	sEIv
saviour	`sEIvj@
savour	`sEIv@
savoury	`sEIv@ri:
	s@:
say	sEI
scab	skAb
scaffold	`skAf@Uld
scaffolding	`skAf@ldIN
scald	sk@:ld
scale	skEIl
scallop	`skOl@p
scalp	skAlp
scalpel	`skAlp@l
scam	skAm
scamp	skAmp
scamper	`skAmp@
scan	skAn
scandal	`skAndl
Scandinavian	skAnd@`nEIvi:@n
scant	skAnt
scapegoat	`skEIpg@Ut
scar	ska:
scarce	skE@s
scarcely	`skE@sli:
scare	skE@
scarecrow	`skE@kr@U
scared	skE@d
scarf	ska:f
scarlet	`ska:l@t
scarlet fever	ska:l@t `fi:v@
scary	`skE@ri:
scathing	`skEIDIN
scatter	`skAt@
scatterbrain	`skAt@brEIn
scatty	`skAti:
scene	si:n
scenery	`si:n@ri:
scent	sEnt
sceptical	`skEptIk@l
schedule	`SEdZu:l, `skEdZu:l
scheme	ski:m
scholar	`skOl@
scholarship	`skOl@SIp
school	sku:l
schooner	`sku:n@
science	`sa:I@ns
scientist	`sa:I@nt@st
scissors	`sIz@z
scoff	skOf
scold	sk@Uld
scone	skOn
scoop	sku:p
scooter	`sku:t@
scope	sk@Up
scorch	sk@:tS
score	sk@:
scorn	sk@:n
scotch	skOtS
scot-free	skOt-`fri:
Scottish	`skOtIS
scoundrel	`ska:Undr@l
scout	ska:Ut
scowl	ska:Ul
scrabble	`skrAbl
scraggy	`skrAgi:
scramble	`skrAmb@l
scrap	skrAp
scrape	skrEIp
scratch	skrAtS
scrawl	skr@:l
scream	skri:m
screech	skri:tS
	skri:n
	skru:
screwdriver	`skru:dra:Iv@
scribble	`skrIb@l
scrimp	skrImp
script	skrIpt
scripture	`skrIptS@
scroll	skr@Ul
scrotum	`skr@Ut@m
scrounge	skra:UndZ
scrub	skrV b
scruff	skrV f
scruffy	`skrV fi:
scrum	skrV m
scrupulous	`skru:pj@l@s
scrutinise	`skru:t@na:Iz
scuba diving	`sku:b@ da:IvIN
scuff	skV f
scuffle	`skV f@l
scullery	`skV l@ri:
sculpture	`skV lptS@
scum	skV m
scurry	`skV ri:
scuttle	`skV tl
sea	si:
seafood	`si:fu:d
seal	si:l
seam	si:m
seance	`sEIOns
search	s@:tS
seashore	`si:S@:
seasickness	`si:sIkn@s
seaside	`si:sa:Id
season	`si:z@n
seasonal	`si:z@n@l
seat	si:t
sec	sEk
secateurs	`sEk@t@z, sEk@`t@:z
second	`sEk@nd
secondary	`sEk@ndri:
second-class	`sEk@nd-kla:s
second-hand	sEk@nd-`hAnd
second-rate	`sEk@nd-rEIt
secret	`si:kr@t
secretary	`sEkr@tri:, `sEkr@t@ri:
secrete	s@`kri:t
sect	sEkt
section	`sEkS@n
sector	`sEkt@
secular	`sEkj@l@
secure	s@`kju:@, -`kjU@
security	s@`kju:r@ti:
sedan	s@`dAn
sedate	s@`dEIt
sedative	`sEd@tIv
sediment	`sEd@m@nt
seduce	s@`dju:s
see	si:
seed	si:d
seedling	`si:dlIN
seedy	`si:di:
seek	si:k
seem	si:m
seep	si:p
seesaw	`si:s@:
segment	`sEgm@nt
segregate	`sEgr@gEIt
seize	si:z
seldom	`sEld@m
select	s@`lEkt
selective	s@`lEktIv
self	sElf
self-centred	sElf-`sEnt@d
self-confident	sElf-`kOnf@d@ns
self-conscious	sElf-`kOnS@s
self-defence	sElf-d@`fEns
selfish	`sElfIS
self-service	sElf-`s@:v@s
sell	sEl
semen	`si:m@n
semester	s@`mEst@
semicolon	sEmi:`k@Ul@n, `sEmi:k@Ul@n
semi-conscious	sEmi:-`kOnS@s
semi-detached	sEmi:d@`tAtSt
seminar	`sEm@na:
seminary	`sEm@nri:
	sEmi:`trEIl@
Senate	`sEn@t
senator	`sEn@t@
send	sEnd
senile	`sEna:Il
senior	`si:nj@
sensation	sEn`sEIS@n
sensational	sEn`sEIS@n@l
sense	sEns
sensible	`sEns@b@l
sensitive	`sEns@tIv
sent	sEnt
sentence	`sEnt@ns
sentiment	`sEnt@m@nt
sentimental	sEnt@`mEntl
sentry	`sEntri:
separate	`sEpr@t
Sept.	s@p`tEmb@
September	s@p`tEmb@
septic	`sEptIk
septic tank	sEptIk `tANk
sequel	`si:kw@l
sequence	`si:kw@ns
Serbian	`s@:bi:@n
serene	s@`ri:n
sergeant	`sa:dZ@nt
serial	`sI@ri:@l
series	`sI@ri:z
serious	`sI@ri:@s
sermon	`s@:m@n
serpent	`s@:p@nt
serrated	s@`rEIt@d
serum	`sI@r@m
servant	`s@:v@nt
serve	s@:v
service	`s@:v@s
serviceable	`s@:v@s@b@l
service station	`s@:v@s stEIS@n
serviette	s@:vi:`Et
serving	`s@:vIN
serving spoon	`s@:vIN spu:n
session	`sES@n
set	sEt
setback	`sEtbAk
settee	sE`ti:, s@`ti:
setting	`sEtIN
settle	`sEtl
set-up	`sEt-V p
seven	`sEv@n
seventeen	sEv@n`ti:n
seventeenth	sEv@n`ti:nT
seventh	`sEv@nT
seventies	`sEv@nti:z
seventy	`sEv@nti:
sever	`sEv@
several	`sEvr@l
severance pay	`sEvr@ns pEI
severe	s@`vI@
sew	s@U
sewage	`su:IdZ
sewer	`su:@
sewerage	`su:@rIdZ
sewing machine	`s@UIN m@Si:n
sex	sEks
sexism	`sEksIz@m
sexy	`sEksi:
shabby	`SAbi:
shack	SAk
shade	SEId
shadow	`SAd@U
shaggy	`SAgi:
shake	SEIk
shake-up	`SEIkV p
shall	SAl
shallow	`SAl@U
sham	SAm
shame	SEIm
shampoo	SAm`pu:
shandy	`SAndi:
shan't	Sa:nt
shanty	`SAnti:
shape	SEIp
share	SE@
shareholder	`SE@h@Uld@
shark	Sa:k
sharp	Sa:p
sharpener	`Sa:pn@
shatter	`SAt@
shave	SEIv
shawl	S@:l
shear	SI@
shed	SEd
sheep	Si:p
sheepish	`Si:pIS
sheer	SI@
sheet	Si:t
	SElf
shell	SEl
shellfish	`SElfIS
shelter	`SElt@
shelve	SElv
shelving	`SElvIN
shield	Si:ld
shift	SIft
shifty	`SIfti:
shimmer	`SIm@
shin	SIn
shine	Sa:In
shingle	`SINg@l
ship	SIp
shipment	`SIpm@nt
shipshape	`SIpSEIp
shirk	S@:k
shirt	S@:t
shish kebab	`SIS k@bAb
shit	SIt
shiver	`SIv@
shock	SOk
shoddy	`SOdi:
shoe	Su:
shone	SOn
shook	SUk
shoot	Su:t
shop	SOp
shop assistant	`SOp @sIst@nt
shopkeeper	`SOpki:p@
shoplift	`SOplIft
shop steward	SOp `stju:@d
shore	S@:
shorn	S@:n
short	S@:t
shortage	`S@:tIdZ
shortcoming	`S@:tkV mIN
shorten	`S@:t@n
shorthand	`S@:thAnd
shortly	`S@:tli:
short-sighted	S@:t-`sa:It@d
short-tempered	S@:t-`tEmp@d
shot	SOt
shotgun	`SOtgV n
should	SUd
shoulder	`S@Uld@
shout	Sa:Ut
shove	SV v
shovel	`SV v@l
show	S@U
showdown	`S@Uda:Un
shower	`Sa:U@
show-off	`S@U-Of
showy	`S@Ui:
shred	SrEd
shrewd	Sru:d
shriek	Sri:k
shrill	SrIl
shrimp	SrImp
shrink	SrINk
shrivel	`SrIv@l
shrub	SrV b
shrug	SrV g
shudder	`SV d@
shuffle	`SV f@l
shun	SV n
shut	SV t
shutter	`SV t@
shy	Sa:I
sibling	`sIblIN
sick	sIk
sicken	`sIk@n
sickening	`sIk@nIN
sickie	`sIki:
sickly	`sIkli:
sickness	`sIkn@s
side	sa:Id
side-effects	`sa:Id-@fEkts
sideshow	`sa:IdS@U
sideways	`sa:IdwEIz
siege	si:dZ
siesta	si:`Est@
	sIv
sift	si:ft
sigh	sa:I
sight	sa:It
sightseeing	`sa:Itsi:IN
	sa:In
signal	`sIgn@l
signature	`sIgn@tS@
significant	sIg`nIf@k@nt
silence	`sa:Il@ns
silk	sIlk
silkworm	`sIlkw@:m
sill	sIl
silly	`sIli:
silver	`sIlv@
similar	`sIm@l@
simmer	`sIm@
simple	`sImp@l
simple-minded	`sImp@l-ma:Ind@d
simultaneous	sIm@l`tEIni:@s
sin	sIn
since	sIns
sincere	sIn`sI@, s@n-
sincerely	sIn`sI@li:, s@n-
sing	sIN
singe	sIndZ
single	`sINg@l
single-handed	sINg@l-`hAnd@d
single-minded	sINg@l-`ma:Ind@d
singlet	`sINl@t, `sINgl@t
singsong	`sINsON
singular	`sINgj@l@
sinister	`sIn@st@
sink	sINk
sinker	`sINk@
sinus	`sa:In@s
sinusitis	sa:In@`sa:It@s
sip	sIp
sir	s@:
siren	`sa:Ir@n
sissy	`sIsi:
sister	`sIst@
sister-in-law	`sIst@r-In-l@:
sit	sIt
sitcom	`sItkOm
site	sa:It
sit-in	`sIt-In
sitter	`sIt@
sitting room	`sItIN ru:m
situated	`sItSu:EIt@d
situation	sItSu:`EIS@n
six	sIks
sixteen	sIks`ti:n
sixteenth	sIks`ti:nT
sixth	sIksT
sixty	`sIksti:
size	sa:Iz
sizeable	`sa:Iz@b@l
sizzle	`sIz@l
skate	skEIt
skein	skEIn
skeleton	`skEl@tn
sketch	skEtS
sketchy	`skEtSi:
skewer	`skju:@
ski	ski:
skid	skId
skilful	`skIlf@l
skill	skIl
skim	skIm
skimp	skImp
skimpy	`skImpi:
skin	skIn
skinny	`skIni:
skip	skIp
skirt	sk@:t
skivvy	`skIvi:
skull	skV l
sky	ska:I
skyscraper	`ska:IskrEIp@
slab	slAb
slack	slAk
slacken	`slAk@n
slam	slAm
slammer	`slAm@
slander	`slAnd@
slang	slAN
slant	slAnt, sla:nt
slap	slAp
slapdash	`slApdAS
slapstick	`slApstIk
slash	slAS
slat	slAt
slate	slEIt
slaughter	`sl@:t@
slave	slEIv
slay	slEI
sleazy	`sli:zi:
sledge	slEdZ
sledgehammer	`slEdZhAm@
sleek	sli:k
sleep	sli:p
sleeve	sli:v
slender	`slEnd@
slice	sla:Is
slick	slIk
slide	sla:Id
slight	sla:It
slim	slIm
slime	sla:Im
sling	slIN
slink	slINk
slinky	`slINki:
slip	slIp
slippers	`slIp@z
slippery	`slIp@ri:, `slIpri:
slippery dip	`slIpri: dIp
slit	slIt
slob	slOb
slobber	`slOb@
slog	slOg
slogan	`sl@Ug@n
slop	slOp
	sl@Up
sloppy	`slOpi:
sloppy joe	slOpi: `dZ@U
slosh	slOS
sloshed	slOSt
slot	slOt
slouch	sla:UtS
slovenly	`slV v@nli:
slow	sl@U
sludge	slV dZ
slug	slV g
sluggish	`slV gIS
slum	slV m
slump	slV mp
slung	slV N
slur	sl@:
slurp	sl@:p
slush	slV S
slut	slV t
sly	sla:I
smack	smAk
small	sm@:l
smallgoods	`sm@:lgUdz
smallpox	`sm@:lpOks
smart	sma:t
smash	smAS
smear	smI@
smell	smEl
smelt	smElt
smelter	`smElt@
smile	sma:Il
smirk	sm@:k
smithereens	smID@`ri:nz
smog	smOg
smoke	sm@Uk
smokescreen	`sm@Ukskri:n
smooth	smu:D
smorgasbord	`sm@:g@zb@:d
smother	`smV D@
smoulder	`sm@Uld@
smudge	smV dZ
smug	smV g
smuggle	`smV g@l
snack	snAk
snag	snAg
snail	snEIl
snake	snEIk
snap	snAp
snappy	`snApi:
snapshot	`snApSOt
snarl	sna:l
snatch	snAtS
sneak	sni:k
sneer	snI@
sneeze	sni:z
sniff	snIf
sniffle	`snIf@l
snigger	`snIg@
snip	snIp
snipe	sna:Ip
snivel	`snIv@l
snob	snOb
snooker	`snu:k@
snoop	snu:p
snooty	`snu:ti:
snooze	snu:z
snore	sn@:
	`sn@:k@l
snort	sn@:t
snout	sna:Ut
snow	sn@U
snub	snV b
snug	snV g
snuggle	`snV g@l
so	s@U
soak	s@Uk
so-and-so	`s@U-@n-s@U
soap	s@Up
soar	s@:
sob	sOb
sober	`s@Ub@
soccer	`sOk@
social	`s@US@l
socialise	`s@US@la:Iz
socialism	`s@US@lIz@m
social security	s@US@l s@`kju:r@ti:
society	s@`sa:I@ti:
sociology	s@Usi:`Ol@dZi:
sock	sOk
socket	`sOk@t
soda	`s@Ud@
sodium	`s@Udi:@m
sodium bicarbonate	`s@Udi:@m ba:I`ka:b@n@t
sofa	`s@Uf@
sofa bed	`s@Uf@ bEd
soft	sOft
soggy	`sOgi:
soil	s@:Il
solar	`s@Ul@
sold	s@Uld
soldier	`s@UldZ@
sole	s@Ul
solemn	`sOl@m
solicitor	s@`lIs@t@
solid	`sOl@d
solitary	`sOl@tri:
solo	`s@Ul@U
soloist	`s@Ul@U@st
soluble	`sOlj@b@l
solution	s@`lu:S@n
solve	sOlv
sombre	`sOmb@
some	sV m
somebody	`sV mbOdi:, `sV mb@di:
somehow	`sV mha:U
someone	`sV mwV n
somersault	`sV m@sOlt
something	`sV mTIN
sometime	`sV mta:Im
sometimes	`sV mta:Imz
somewhere	`sV mwE@
son	sV n
song	sON
son-in-law	`sV n-In-l@:
soon	su:n
soot	sUt
soothe	su:D
sophisticated	s@`fIst@kEIt@d
sopping	`sOpIN
soprano	s@`pra:n@U
sorbet	`s@:bEI
sordid	`s@:d@d
sore	s@:
sorrow	`sOr@U
sorry	`sOri:
sort	s@:t
souffle	`su:flEI
sought	s@:t
soul	s@Ul
sound	sa:Und
soup	su:p
sour	`sa:U@
source	s@:s
south	sa:UT
Southern Cross	sV D@n `krOs
souvenir	su:v@`nI@
soviet	`s@Uvi:@t, `sOv-
sow	s@U
soya bean	`s@:I@ bi:n
soya sauce	`s@:I@ s@:s
spa	spa:
space	spEIs
spacecraft	`spEIskra:ft
spacious	`spEIS@s
spade	spEId
spaghetti	sp@`gEti:
span	spAn
Spanish	`spAnIS
spank	spANk
spanner	`spAn@
spare	spE@
spark	spa:k
sparkle	`spa:k@l
spark plug	`spa:k plV g
sparse	spa:s
spasm	`spAz@m
spasmodic	spAz`mOdIk
spastic	`spAstIk
speak	spi:k
speaker	`spi:k@
spear	spI@
special	`spES@l
specialise	`spES@la:Iz
specialised	`spES@la:Izd
specialist	`spES@l@st
specially	`spES@li:
species	`spi:si:z, -Si:z
specific	sp@`sIfIk
specification	spEs@f@`kEIS@n
specify	`spEs@fa:I
specimen	`spEs@m@n
speck	spEk
spectacle	`spEkt@k@l
spectacles	`spEkt@k@lz
spectacular	spEk`tAkjUl@
spectator	spEk`tEIt@, `spEktEIt@
spectrum	`spEktr@m
speculate	`spEkj@lEIt
sped	spEd
speech	spi:tS
speed	spi:d
speedometer	spi:`dOm@t@
spell	spEl
spelt	spElt
spencer	`spEns@
spend	spEnd
spendthrift	`spEndTrIft
sperm	sp@:m
spew	spju:
sphere	sfI@
spice	spa:Is
spider	`spa:Id@
spike	spa:Ik
spiky	spa:Iki:
spill	spIl
spin drier	spIn `dra:I@
spin-dry	spIn-`dra:I
spine	spa:In
spineless	`spa:Inl@s
spinnaker	`spIn@k@
spinning wheel	`spInIN wi:l
spinster	`spInst@
spiny	`spa:Ini:
spiny anteater	spa:Ini: `Anti:t@
	`spa:Ir@l
	`spa:I@
spirit	`spIr@t
spiritual	`spIrItSu:@l
spit	spIt
spite	spa:It
spiteful	`spa:ItfUl
splash	splAS
splatter	`splAt@
spleen	spli:n
splendid	`splEnd@d
splint	splInt
splinter	`splInt@
split	splIt
split-level	`splIt-lEv@l
splutter	`splV t@
spoil	sp@:Il
	sp@Uk
spoken	`sp@Uk@n
spokesperson	`sp@Uksp@:s@n
sponge	spV ndZ
sponsor	`spOns@
sponsorship	`spOns@SIp
spontaneous	spOn`tEIni:@s
spook	spu:k
spooky	`spu:ki:
spoon	spu:n
sporadic	sp@`rAdIk
sport	sp@:t
spot	spOt
spotless	`spOtl@s
spotted	`spOt@d
spotty	`spOti:
spouse	spa:Us
spout	spa:Ut
sprain	sprEIn
sprang	sprAN
sprawl	spr@:l
spray	sprEI
spread	sprEd
spree	spri:
spring	sprIN
spring-clean	sprIN-`kli:n
sprinkle	`sprINk@l
	`sprINkl@
sprint	sprInt
sprout	spra:Ut
sprouts	spra:Uts
sprung	sprV N
spud	spV d
spun	spV n
spur	sp@:
spurt	sp@:t
spy	spa:I
squabble	`skwOb@l
squad	skwOd
squalid	`skwOl@d
squander	`skwOnd@
	skwE@
squash	skwOS
squeak	skwi:k
squeal	skwi:l
squeeze	skwi:z
squint	skwInt
squirm	skw@:m
squirt	skw@:t
St	??
stab	stAb
stable	`stEIb@l
stack	stAk
stadium	`stEIdi:@m
staff	sta:f
stage	stEIdZ
stagger	`stAg@
stagnant	`stAgn@nt
stain	stEIn
stair	stE@
staircase	`stE@kEIs
stake	stEIk
stale	stEIl
stalk	st@:k
stall	st@:l
stamina	`stAm@n@
stammer	`stAm@
	stAmp
stamp duty	`stAmp dju:ti:
stampede	stAm`pi:d
stand	stAnd
standard	`stAnd@d
stand-by	`stAnd-ba:I
standing	`stAndIN
standstill	`stAndstIl
staple	`stEIp@l
stapler	`stEIpl@
star	sta:
starch	sta:tS
stare	stE@
stark	sta:k
start	sta:t
startle	`sta:tl
starve	sta:v
state	stEIt
statement	`stEItm@nt
static	`stAtIk
station	`stEIS@n
station wagon	`stEIS@n wAg@n
stationary	`stEIS@nri:, `stEIS@n@ri:
stationery	`stEIS@nri:, `stEIS@n@ri:
statistics	st@`tIstIks
statue	`stAtSu:
status	`stEIt@s, `stAt@s
statute	`stAtSu:t
statutory declaration	`stAtS@tri:  dEkl@`rEIS@n
stay	stEI
STD	Es ti: `di:
steadfast	`stEdfa:st
steady	`stEdi:
steak	stEIk
steal	sti:l
steam	sti:m
steel	sti:l
steep	sti:p
steer	stI@
steering wheel	`stI@rIN wi:l
stem	stEm
stenographer	st@`nOgr@f@
step	stEp
stepfather	`stEpfa:D@
stepladder	`stEplAd@
stepmother	`stEpmV D@
stereo	`stEri:@U
sterile	`stEra:Il
sterilise	`stEr@la:Iz
stern	st@:n
stethoscope	`stET@sk@Up
stew	stju:
steward	`stju:@d
stick	stIk
sticker	`stIk@
sticky	`stIki:
stiff	stIf
stigma	`stIgm@
still	stIl
stimulant	`stImj@l@nt
stimulate	`stImj@lEIt
sting	stIN
stingy	`stIndZi:
stink	stINk
stir	st@:
stitch	stItS
stock	stOk
stock exchange	`stOk EkstSEIndZ
stocking	`stOkIN
stockman	`stOkm@n
stocky	`stOki:
stole	st@Ul
stolen	`st@Ul@n
stomach	`stV m@k
stone	st@Un
stone-cold	st@Un-`k@Uld
stood	stUd
stool	stu:l
stoop	stu:p
stop	stOp
stopover	`stOp@Uv@
stopper	`stOp@
storage	`st@:rIdZ
store	st@:
storey	`st@:ri:
storm	st@:m
story	`st@:ri:
stout	sta:Ut
stove	st@Uv
straggle	strAgl
straight	strEIt
straightaway	strEIt@`wEI
straightforward	strEIt`f@:w@d
strain	strEIn
strained	strEInd
strand	strAnd
strange	strEIndZ
stranger	`strEIndZ@
strangle	`strANgl
strap	strAp
strategic	str@`ti:dZIk
strategy	`strAt@dZi:
	str@:
stray	strEI
streak	stri:k
stream	stri:m
streamer	`stri:m@
street	stri:t
strength	strENT
strenuous	`strEnju:@s
stress	strEs
stretch	strEtS
stricken	`strIk@n
strict	strIkt
stride	stra:Id
strife	stra:If
strike	stra:Ik
striking	`stra:IkIN
string	strIN
strip	strIp
	stra:Ip
stripper	`strIp@
strive	stra:Iv
strode	str@Ud
stroke	str@Uk
stroll	str@Ul
stroller	`str@Ul@
strong	strON
strove	str@Uv
struck	strV k
structure	`strV ktS@
struggle	`strV g@l
stub	stV b
stubborn	`stV b@n
stubby	`stV bi:
stuck	stV k
stuck-up	`stV k-V p
student	`stju:dnt
studio	`stju:di:@U
study	`stV di:
stuff	stV f
stuffing	`stV fIN
stuffy	`stV fi:
stumble	`stV mb@l
stump	stV mp
stumpy	`stV mpi:
stun	stV n
stung	stV N
stunning	`stV nIN
stupid	`stju:p@d
sturdy	`st@:di:
stutter	`stV t@
style	sta:Il
stylish	`sta:IlIS
subdivide	`sV bd@va:Id, sV bd@`va:Id
subdue	s@b`dju:
subdued	s@b`dju:d
subject	`sV bdZEkt
submarine	`sV bm@ri:n, sV bm@`ri:n
submerge	s@b`m@:dZ
submit	s@b`mIt
subordinate	s@`b@:d@n@t
subscribe	s@b`skra:Ib
subscriber	s@b`skra:Ib@
subscription	s@b`skrIpS@n
subsequent	`sV bs@kw@nt
subside	s@b`sa:Id
subsidiary	s@b`sIdZ@ri:
subsidy	`sV bs@di:
substance	`sV bst@ns
substantial	s@b`stAnS@l
substitute	`sV bst@tSu:t
subtitle	`sV bta:Itl
subtle	`sV tl
subtract	s@b`trAkt
suburb	`sV b@:b
suburbia	s@`b@:bi:@
succeed	s@k`si:d
success	s@k`sEs
such	sV tS
suck	sV k
sudden	`sV dn
suds	sV dz
sue	su:
suede	swEId
suffer	`sV f@
suffering	`sV f@rIN
sufficient	s@`fIS@nt
suffix	`sV fIks
suffocate	`sV f@kEIt
sugar	`SUg@
suggest	s@`dZEst
suicidal	su:@`sa:Idl
suicide	`su:@sa:Id
suit	su:t
suitable	`su:t@b@l
suitcase	`su:tkEIs
suite	swi:t
suited	`su:t@d
sulk	sV lk
sullen	`sV l@n
sultana	sV l`ta:n@
sultry	`sV ltri:
sum	sV m
summary	`sV m@ri:
summer	`sV m@
summit	`sV m@t
summon	`sV m@n
summons	`sV m@nz
sumptuous	`sV mptSu:@s
sun	sV n
sunbake	`sV nbEIk
sunburn	`sV nb@:n
Sunday	`sV ndEI
sundry	`sV ndri:
sung	sV N
sunglasses	`sV ngla:s@z
sunk	sV Nk
sunken	`sV Nk@n
sunlight	`sV nla:It
sunny	`sV ni:
sunrise	`sV nra:Iz
sunscreen	`sV nskri:n
sunset	`sV nsEt
sunshine	`sV nSa:In
sunstroke	`sV nstr@Uk
suntan	`sV ntAn
super	`su:p@
superannuation	`su:p@rAnju:`EIS@n
superb	s@`p@:b, su:-
superficial	su:p@`fIS@l
superintendent	su:p@rIn`tEnd@nt
superior	s@`pI@ri:@, su:-
superlative	su:`p@:l@tIv
supermarket	`su:p@ma:k@t
superstitious	su:p@`stIS@s
supervise	`su:p@va:Iz
supper	`sV p@
supple	`sV p@l
supplement	`sV pl@m@nt
supply	s@`pla:I
support	s@`p@:t
supportive	s@`p@:tIv
suppose	s@`p@Uz
supposed	s@`p@Uzd
suppress	s@`prEs
supreme	s@`pri:m
sure	S@:
surely	`S@:li:
surf	s@:f
surface	`s@:f@s
surfboard	`s@:fb@:d
surge	s@:dZ
surgeon	`s@:dZ@n
surgery	`s@:dZ@ri:
surly	`s@:li:
surname	`s@:nEIm
surpass	s@`pa:s
surplus	`s@:pl@s
surprise	s@`pra:Iz
surrender	s@`rEnd@
surround	s@`ra:Und
surroundings	s@`ra:UndINz
survey	s@`vEI
surveyor	s@`vEI@
survive	s@`va:Iv
suspect	s@`spEkt
suspend	s@`spEnd
suspense	s@`spEns
suspension	s@`spEnS@n
suspicion	s@`spIS@n
suspicious	s@`spIS@s
suss	sV s
sustain	s@`stEIn
swag	swAg
swagger	`swAg@
swallow	`swOl@U
swam	swAm
swamp	swOmp
swap	swOp
swarm	sw@:m
swarthy	`sw@:Di:
swat	swOt
sway	swEI
swear	swE@
sweat	swEt
sweater	`swEt@
sweep	swi:p
sweeping	`swi:pIN
sweet	swi:t
sweeten	`swi:tn
sweetheart	`swi:tha:t
swell	swEl
swelling	`swElIN
swept	swEpt
swerve	sw@:v
swift	swIft
swim	swIm
swimmers	`swIm@z
swimming pool	`swImIN pu:l
swimsuit	`swImsu:t
swindle	`swIndl
swing	swIN
swipe	swa:Ip
	swItS
switchboard	`swItSb@:d
swollen	`sw@Ul@n
swoop	swu:p
sword	s@:d
swore	sw@:
sworn	sw@:n
swum	swV m
swung	swV N
syllable	`sIl@b@l
syllabus	`sIl@b@s
symbol	`sImb@l
symmetry	`sIm@tri:
sympathy	`sImp@Ti:
symphony	`sImf@ni:
symptom	`sImpt@m
synagogue	`sIn@gOg
syndicate	`sIndIk@t
synonym	`sIn@nIm
synopsis	s@`nOps@s
synthetic	sIn`TEtIk
syringe	s@`rIndZ
syrup	`sIr@p
system	`sIst@m
T, t	ti:
T	ti:
ta	ta:
tab	tAb
tabby	`tAbi:
table	`tEIb@l
tablecloth	`tEIb@lklOT
tablespoon	`tEIb@lspu:n
	`tAbl@t
table tennis	`tEIbl tEn@s
tableware	`tEIb@lwE@
tabloid	`tAbl@:Id
taboo	t@`bu:
tabulate	`tAbj@lEIt
tacit	`tAs@t
taciturn	`tAs@t@:n
tack	tAk
tackle	`tAk@l
tacky	`tAki:
tact	tAkt
tactic	`tAktIk
tactics	`tAktIks
TAFE	tEIf
tag	tAg
tail	tEIl
tailor	`tEIl@
taipan	`ta:IpAn
take	tEIk
takeaway	`tEIk@wEI
take-off	`tEIk-Of
takings	`tEIkINz
talcum powder	`tAlk@m pa:Ud@
tale	tEIl
talent	`tAl@nt
talk	t@:k
talkback	`t@:kbAk
tall	t@:l
tally	`tAli:
talon	`tAl@n
tame	tEIm
tamper	`tAmp@
tampon	`tAmpOn
tan	tAn
tandem	`tAnd@m
tang	tAN
tangent	`tAndZ@nt
tangerine	tAndZ@`ri:n
tangible	`tAndZ@b@l
tangle	`tANg@l
	tANk
tankard	`tANk@d
tanker	`tANk@
tantalise	`tAnt@la:Iz
tantamount	`tAnt@ma:Unt
tantrum	`tAntr@m
tap	tAp
tape	tEIp
taper	`tEIp@
tape-recorder	`tEIp-r@k@:d@
tapestry	`tAp@stri:
tar	ta:
target	`tAg@t
tariff	`tAr@f
tarmac	`ta:mAk
tarnish	`ta:nIS
tarpaulin	ta:`p@:l@n
tarragon	`tAr@g@n
tart	ta:t
tartan	`ta:t@n
Tas.	tAz`mEInj@
task	ta:sk
tassel	`tAs@l
taste	tEIst
tasteful	`tEIstfUl
tasteless	`tEIstl@s
tasty	`tEIsti:
tattered	`tAt@d
tatters	`tAt@z
tattoo	tA`tu:
tatty	`tAti:
taught	t@:t
taunt	t@:nt
taut	t@:t
tautology	t@:`tOl@dZi:
tavern	`tAv@n
tawdry	`t@:dri:
tawny	`t@:ni:
tax	tAks
taxi	`tAksi:
tea	ti:
teabag	`ti:bAg
teach	ti:tS
teacher	`ti:tS@
teacher's aide	`ti:tS@z EId
team	ti:m
teapot	`ti:pOt
tear	tI@
tease	ti:z
teaspoon	`ti:spu:n
teat	ti:t
tea towel	`ti: ta:Ul
tech	tEk
technical	`tEknIk@l
technical college	`tEknIk@l kOlIdZ
technician	tEk`nIS@n
technique	tEk`ni:k
technology	tEk`nOl@dZi:
teddy bear	`tEdi: bE@
tedious	`ti:di:@s
tee	ti:
teem	ti:m
teenager	`ti:nEIdZ@
teens	ti:nz
teeth	ti:T
teetotal	`ti:t@Utl, ti:`t@Utl
telecast	`tEl@ka:st
telecommunications	tEl@k@mju:n@`kEIS@ns
telepathy	t@`lEp@Ti:
telephone	`tEl@f@Un
telephone exchange	`tEl@f@Un Eks`tSEIndZ
telescope	`tEl@sk@Up
television	`tEl@vIZ@n
tell	tEl
teller	`tEl@
temper	`tEmp@
temperament	`tEmpr@m@nt
temperamental	tEmpr@`mEntl
temperature	`tEmpr@tS@
temporary	`tEmpri:, -pr@ri:
tempt	tEmpt
ten	tEn
tenacious	t@`nEIS@s
tenant	`tEn@nt
tend	tEnd
tender	`tEnd@
tendon	`tEnd@n
tenement	`tEn@m@nt
tennis	`tEn@s
tenor	`tEn@
tense	tEns
tent	tEnt
tentacle	`tEnt@k@l
tentative	`tEnt@tIv
tenth	tEnT
tenuous	`tEnju:@s
tepid	`tEp@d
term	t@:m
terminal	`t@:m@n@l
terminate	`t@:m@nEIt
terminology	t@:m@`nOl@dZi:
terminus	`t@:m@n@s
termite	`t@:ma:It
terrace	`tEr@s
terrain	t@`rEIn
terrestrial	t@`rEstri:@l
terrible	`tEr@b@l
terribly	`tEr@bli:
terrific	t@`rIfIk
terrify	`tEr@fa:I
territory	`tEr@tri:, -t@ri:
terror	`tEr@
terrorise	`tEr@ra:Iz
terrorism	`tEr@rIz@m
terse	t@:s
tertiary	`t@:S@ri:
test	tEst
testament	`tEst@m@nt
testicle	`tEstIk@l
testify	`tEst@fa:I
testimonial	tEst@`m@Uni:@l
testimony	`tEst@m@ni:
tether	`tED@
text	tEkst
texta	`tEkst@
textbook	`tEkstbUk
textile	`tEksta:Il
texture	`tEkstS@
Thai	ta:I
than	DAn
thank	TANk
that	DAt
thatch	TAtS
thaw	T@:
the	D@
theatre	`TI@t@
theatrical	Ti:`Atr@k@l
theft	TEft
their	DE@
theirs	DE@z
them	DEm
theme	Ti:m
themselves	D@m`sElvz
then	DEn
theology	Ti:`Ol@dZi:
theorem	`TI@r@m
theory	`TI@ri:
therapeutic	TEr@`pju:tIk
therapy	`TEr@pi:
there	DE@
thereabouts	DE@r@`ba:Uts, `DE@r@ba:Uts
thereafter	DE@r`a:ft@
thereby	DE@`ba:I, `DE@ba:I
therefore	`DE@f@:
there'll	DE@l
thereupon	DE@r@`pOn, `DE@r@pOn
thermometer	T@`mOm@t@
thermos	`T@:mOs, -m@s
thermostat	`T@:m@stAt
thesaurus	T@`s@:r@s
these	Di:z
thesis	`Ti:s@s
they	DEI
thick	TIk
thicket	`TIk@t
thief	Ti:f
thigh	Ta:I
thimble	`TImb@l
thin	TIn
thing	TIN
think	TINk
third	T@:d
thirst	T@:st
thirteen	T@:`ti:n
thirteenth	T@:`ti:nT
thirty	`T@:ti:
this	DIs
thistle	`TIs@l
thong	TON
	T@:n
thorough	`TV r@
thoroughfare	`TV r@fE@
thoroughly	`TV r@li:
those	D@Uz
though	D@U
thought	T@:t
thoughtful	`T@:tfUl
thoughtless	`T@:tl@s
thousand	`Ta:Uz@nd
thousandth	`Ta:Uz@nT
thrash	TrAS
	TrEd
threadbare	`TrEdbE@
threat	TrEt
threaten	`TrEt@n
three	Tri:
three-dimensional	Tri:-d`mEnS@n@l
thresh	TrES
threshold	`TrESh@Uld
threw	Tru:
thrift	TrIft
thrill	TrIl
thriller	`TrIl@
thrive	Tra:Iv
throat	Tr@Ut
throb	TrOb
throne	Tr@Un
throng	TrON
throttle	`TrOtl
through	Tru:
throughout	Tru:`a:Ut
throw	Tr@U
thrust	TrV st
thud	TV d
thug	TV g
thumb	TV m
thump	TV mp
thunder	`TV nd@
Thursday	`T@:zdEI
thus	DV s
thwart	Tw@:t
thyme	ta:Im
thyroid	`Ta:Ir@:Id
tick	tIk
ticket	`tIk@t
tickle	`tIk@l
ticklish	`tIklIS
tiddly	`tIdli:
tide	ta:Id
tidy	`ta:Idi:
tie	ta:I
tier	`tI@
tiger snake	`ta:Ig@ snEIk
tight	ta:It
tights	ta:Its
tile	ta:Il
till	tIl
tilt	tIlt
timber	`tImb@
time	ta:Im
timetable	`ta:ImtEIb@l
timid	`tIm@d
tin	tIn
tinea	`tIni:@
tinge	tInZ
tingle	`tINg@l
tinker	`tINk@
tinkle	`tINk@l
tinnie	`tIni:
tinny	`tIni:
tinsel	`tIns@l
tint	tInt
tiny	`ta:Ini:
tip	tIp
tipsy	`tIpsi:
tirade	ta:I`rEId
tire	ta:I@
tired	ta:I@d
tiring	`ta:I@rIN
tissue	`tISu:
tit	tIt
titbit	`tItbIt
title	`ta:Itl
titter	`tIt@
to	tu:
toad	t@Ud
toadstool	`t@Udstu:l
toast	t@Ust
toaster	`t@Ust@
tobacco	t@`bAk@U
toboggan	t@`bOg@n
today	t@`dEI
toddle	`tOdl
toddler	`tOdl@
toe	t@U
together	t@`gED@
toil	t@:Il
toilet	`t@:Il@t
toiletries	`t@:Il@tri:z
token	`t@Uk@n
told	t@Uld
tolerable	`tOlr@bl
tolerant	`tOl@r@nt
tolerate	`tOl@rEIt
toll	t@Ul
tomato	t@`ma:t@U
tomb	tu:m
tombstone	`tu:mst@Un
tomcat	`tOmkAt
tomorrow	t@`mOr@U
ton	tV n
tone	t@Un
tongue	tV N
tonic	`tOnIk
tonight	t@`na:It
tonne	tOn
tonsil	`tOns@l
tonsilitis	tOns@`la:It@s
too	tu:
took	tUk
tool	tu:l
toot	tu:t
tooth	tu:T
toothache	`tu:TEIk
toothbrush	`tu:TbrV S
toothpaste	`tu:TpEIst
toothpick	`tu:TpIk
top	tOp
topic	`tOpIk
topical	`tOpIkl
topless	`tOpl@s
topping	`tOpIN
topple	`tOpl
torch	t@:tS
tore	t@:
torment	`t@:mEnt
torn	t@:n
tortuous	`t@:tSu:@s
torture	`t@:tS@
toss	tOs
total	`t@Ut@l
totalitarian	t@U;tAl@`tE@ri:@n
totem	`t@Ut@m
totter	`tOt@
touch	tV tS
touchy	`tV tSi:
tough	tV f
tour	t@:, tU@
tourism	`t@:rIzm, `tU@rIzm
tourist	`t@:rIst, `tU@rIst
tournament	`t@:n@m@nt
tow	t@U
towards	t@`w@:dz
towel	`ta:U@l
tower	ta:U@
town	ta:Un
town hall	ta:Un `h@:l
toxic	`tOksIk
toxin	`tOks@n
toy	t@:I
trace	trEIs
track	trAk
tracksuit	`trAksu:t
tractor	`trAkt@
trade	trEId
trade-in	`trEId-In
trademark	`trEIdma:k
trade union	trEId `ju:nj@n
tradition	tr@`dIS@n
traffic	`trAfIk
traffic jam	`trAfIk dZAm
tragedy	`trAdZ@di:
tragic	`trAdZIk
trail	trEIl
trailer	`trEIl@
train	trEIn
trainee	trEI`ni:
training	`trEInIN
trait	trEIt, trEI
traitor	`trEIt@
tram	trAm
trample	`trAmp@l
tranquil	`trANkw@l
tranquilliser	`trANkw@la:Iz@
transfer	trAns`f@:, tra:ns-
transform	trAns`f@:m, tra:ns-
transfusion	trAns`fju:Z@n
transitive	`trAns@tIv
translate	trAnz`lEIt
transmit	trAnz`mIt
transparent	trAn`spE@r@nt
transplant	trAn`splAnt, tra:n-
transport	`trAnsp@:t, `tra:n-
trap	trAp
trauma	`tr@:m@
travel	`trAv@l
travel agent	`trAv@l EIdZ@nt
tray	trEI
treacherous	`trEtS@r@s
treachery	`trEtS@ri:
tread	trEd
treasure	`trEZ@
treasurer	`trEZ@r@
treat	tri:t
	tri:
tremble	`trEmb@l
tremendous	tr@`mEnd@s
trend	trEnd
trendy	`trEndi:
trespass	`trEsp@s
trial	tra:I@l
	`tra:IANgl
tribunal	tr@`bju:n@l
trick	trIk
trickle	`trIkl
tried	tra:Id
trim	trIm
trip	trIp
triple	`trIpl
triumph	`tra:IV mf
trivial	`trIvi:@l
trod	trOd
trodden	`trOdn
	`trOli:
troop	tru:p
tropical	`trOpIkl
tropics	`trOpIks
trouble	`trV bl
trousers	`tra:Uz@z
truck	trV k
trudge	trV dZ
true	tru:
trumpet	`trV mp@t
trunk	trV Nk
trust	trV st
trustworthy	`trV stw@:Di:
truth	tru:T
truthful	`tru:TfUl
try	tra:I
T-shirt	`ti:-S@:t
tube	tju:b
tuck	tV k
Tuesday	`tju:zdEI
tuft	tV ft
tug	tV g
tuition	tju:`ISn
tumble	`tV mbl
tumour	`tju:m@
tuna	`tju:n@
tune	tju:n
tunnel	`tV n@l
Turkish	`t@:kIS
turn	t@:n
turquoise	`t@:kw@:Iz
tutor	`tju:t@
TV	ti:`vi:
tweezers	`twi:z@z
twelfth	twElfT
twelve	twElv
twentieth	`twEnti:@T
twenty	`twEnti:
twice	twa:Is
twig	twIg
twilight	`twa:Ila:It
twin	twIn
twinge	twIndZ
twinkle	`twINkl
twist	twIst
two	tu:
tying	`ta:IIN
type	ta:Ip
typewriter	`ta:Ipra:It@
typhoid	`ta:If@:Id
typhoon	ta:I`fu:n
typical	`tIpIkl
typically	`tIpIkli:
tyre	ta:I@
U, u	ju:
ugly	`V gli:
ulcer	`V ls@
ultimate	`V lt@m@t
um	V m
umbrella	V m`brEl@
umpire	`V mpa:I@
umpteen	V mp`ti:n, `V mpti:n
unanimous	ju:`nAn@m@s
uncanny	V n`kAni:
uncle	`V Nk@l
unconscious	V n`kOnS@s
under	`V nd@
underarm	`V nd@ra:m
underdone	V nd@`dV n
undergo	V nd@`g@U
undergrowth	`u:nd@gr@UT
underhand	`V nd@hAnd
underline	V nd@`la:In
underneath	V nd@`ni:T
underpants	`V nd@pAnts
understand	V nd@`stAnd
understate	V nd@`stEIt
undertake	V nd@`tEIk
undertaker	`V nd@tEIk@
underwear	`V nd@wE@
undo	V n`du:
uneasy	V n`i:zi:
unemployed	V n@m`pl@:Id
uneventful	V n@`vEntfUl
unforgettable	V nf@`gEt@b@l
uniform	
unify	`ju:n@fa:I
unilateral	ju:ni:`lAt@r@l, -`lAtr@l, ju:n@-
uninterested	V n`Intr@st@d
union	`ju:nj@n
unique	ju:`ni:k
unisex	`ju:ni:sEks
unison	`ju:n@s@n
unit	`ju:n@t
unite	ju:`na:It
universal	ju:n@`v@:s@l
universe	`ju:n@v@:s
university	ju:n@`v@:s@ti:
unknown	V n`n@Un
unlawful	V n`l@:fUl
unless	V n`lEs, @n-
unravel	V n`rAv@l
unreal	V n`ri:l
unrest	V n`rEst
unscathed	V n`skEIDd
unscrew	V n`skru:
unscrupulous	V n`skru:pjUl@s
unsettle	V n`sEtl
untangle	V n`tANgl
unthinkable	V n`TINk@b@l
untie	V n`ta:I
until	V n`tIl
unusual	V n`ju:Zu:@l
unwieldy	V n`wIldi:
up	V p
upbringing	`V pbrININ
update	V p`dEIt
upgrade	V p`grEId
upheaval	V p`hi:v@l
uphill	V p`hIl
uphold	V p`h@Uld
upholstery	V p`h@Ulstri:
upkeep	`V pki:p
up-market	`V p-ma:k@t
upon	@`pOn
upper	`V p@
uppermost	`V p@m@Ust
upright	`V pra:It
uprising	`V pra:IzIN
uproar	`V pr@:
uproarious	V p`r@:ri:@s
upset	V p`sEt
upside down	V psa:Id `da:Un
upstairs	V p`stE@z
upstream	V p`stri:m
uptight	V p`ta:It
up-to-date	V p-t@-`dEIt
upturn	`V pt@:n
upward	`V pw@d
upwards	`V pw@dz
upwind	V p`wInd
uranium	ju:`rEIni:@m
urban	`@:b@n
urbane	@:`bEIn
urge	@:dZ
urgent	`@:dZ@nt
urinal	`ju:r@n@l, ju:`ra:In@l
urine	`ju:r@n, -a:In
urn	@:n
us	V s
use	ju:z
used	ju:st
usual	`ju:Zu:@l
ute	ju:t
utensil	ju:`tEns@l
uterus	`ju:t@r@s
utilities	ju:`tIl@ti:z
utility truck	ju:`tIl@ti: trV k
utter	`V t@
V, v	vi:
v	`v@:s@s
vacancy	`vEIk@nsi:
vacant	`vEIk@nt
vacation	v@`kEIS@n
vaccine	`vAksi:n, vAk`si:n
vacuum	`vAkju:m
vagina	v@`dZa:In@
vague	vEIg
vain	vEIn
valid	`vAl@d
valley	`vAli:
valuable	`vAlju:b@l
value	`vAlju:
valve	vAlv
van	vAn
vandal	`vAnd@l
vanilla	v@`nIl@
vanish	`vAnIS
vanity	`vAn@ti:
vapour	`vEIp@
variety	v@`ra:I@ti:
various	`vE@ri:@s
varnish	`va:nIS
vary	`vE@ri:
vase	va:z
vast	va:st
vat	vAt
VCR	vi: si: `a:
VDU	vi: di: `ju:
veal	vi:l
vegan	`vi:g@n
vegetable	`vEdZt@b@l
vegetarian	vEdZ@`tE@ri:@n
vegetation	vEdZ@`tEIS@n
vegie	`vEdZi:
vehement	`vi:@m@nt
vehicle	`vi:Ik@l, `vi:@k@l
veil	vEIl
vein	vEIn
velvet	`vElv@t
veneer	v@`nI@
venereal disease	v@`nI@ri:@l d@zi:z
vengeance	`vEndZ@ns
venom	`vEn@m
ventilate	`vEnt@lEIt
venture	`vEntS@
venue	`vEnju:
veranda	v@`rAnd@
verb	v@:b
verbal	`v@:b@l
verdict	`v@:dIkt
verify	`vEr@fa:I
versatile	`v@:s@ta:Il
verse	v@:s
version	`v@:Z@n
versus	`v@:s@s
vertebra	`v@:t@br@
vertical	`v@:tIk@l
very	`vEri:
vessel	`vEs@l
vet	vEt
veto	`vi:t@U
vex	vEks
via	`va:I@
vibrate	va:I`brEIt
Vic.	vIk`t@:ri:@
vice	va:Is
vice versa	va:Is@ `v@:s@, va:Is `v@:s@
vicinity	v@`sIn@ti:
vicious	`vIS@s
victim	`vIkt@m
victimise	`vIkt@ma:Iz
victory	`vIkt@ri:, -tri:
video	`vIdi:@U
videotape	`vIdi:@UtEIp
Vietnamese	vi:;Etn@`mi:z
view	vju:
viewer	`vju:@
vigorous	`vIg@r@s
vile	va:Il
village	`vIlIdZ
villain	`vIl@n
vindictive	vIn`dIktIv
vine	va:In
vinegar	`vInIg@
vineyard	`vInj@d
vintage	`vIntIdZ
vinyl	`va:In@l
violent	`va:I@l@nt
violin	va:I@`lIn
VIP	vi: a:I `pi:
virgin	`v@:dZ@n
virile	`vIra:Il
virtue	`v@:tSu:
virulent	`vIr@l@nt
virus	`va:Ir@s
visa	`vi:z@
visible	`vIz@b@l
vision	`vIZ@n
visit	`vIz@t
visual	`vIZu:@l
visual display unit	;vIZju:@l d@`splEI ju:n@t
visualise	`vIZj@la:Iz
vital	`va:It@l
vitality	va:I`tAl@ti:
vitamin	`va:It@m@n, `vIt-
vivacious	v@`vEIS@s
vivid	`vIv@d
vocabulary	v@`kAbj@l@ri:
vocal	`v@Uk@l
vocalist	`v@Uk@l@st
vogue	v@Ug
voice	v@:Is
void	v@:Id
volcano	vOl`kEIn@U
volley	`vOli:
volleyball	`vOli:b@:l
volume	`vOlju:m
voluntary	`vOl@ntri:
volunteer	vOl@n`tI@
vomit	`vOm@t
vote	v@Ut
voucher	`va:UtS@
vow	va:U
vowel	`va:U@l
voyage	`v@:IIdZ
vs	`v@:s@s
vulgar	`vV lg@
vulnerable	`vV lnr@b@l, -n@r@b@l
W, w	`dV b@lju:
W	wEst
WA	wEst@n @`strEIlj@
wad	wOd
waddle	`wOdl
wade	wEId
wafer	`wEIf@
wag	wAg
wage	wEIdZ
wager	`wEIdZ@
wail	wEIl
waist	wEIst
wait	wEIt
waiter	`wEIt@
wake	wEIk
walk	w@:k
walkover	`w@:k@Uv@
wall	w@:l
wallet	`wOl@t
wallpaper	`w@:lpEIp@
waltz	w@:ls, wOls
wander	`wOnd@
wane	wEIn
wangle	`wANg@l
wank	wAnk
want	wOnt
war	w@:
ward	w@:d
warden	`w@:d@n
warder	`w@:d@
wardrobe	`w@:dr@Ub
warehouse	`wE@ha:Us
warfare	`w@:fE@
warm	w@:m
warn	w@:n
warning	`w@:nIN
warp	w@:p
warped	w@:pt
warrant	`wOr@nt
warranty	`wOr@nti:
wart	w@:t
wary	`wE@ri:
was	wOz
wash	wOS
washed-out	`wOSt-a:Ut
washer	`wOS@
waste	wEIst
wastepaper basket	wEIst`pEIp@ ba:sk@t
watch	wOtS
water	`w@:t@
watercolour	`w@:t@kV l@
waterfront	`w@:t@frV nt
waterlogged	`w@:t@lOgd
waterproof	`w@:t@pru:f
waterski	`w@:t@ski:
watertight	`w@:t@ta:It
watt	wOt
wattle	`wOtl
wave	wEIv
wax	wAks
way	wEI
way-out	`wEI-a:Ut
we	wi:
weak	wi:k
wealth	wElT
wealthy	`wElTi:
weapon	`wEp@n
wear	wE@
weary	`wI@ri:
weather	`wED@
weave	wi:v
	wEb
webbed	wEbd
wedding	`wEdIN
	wEdZ
Wednesday	`wEnzdEI, `wEdn-
weed	wi:d
week	wi:k
weekday	`wi:kdEI
weekend	wi:k`End
weekly	`wi:kli:
weep	wi:p
weigh	wEI
weight	wEIt
weird	wI@d
welcome	`wElk@m
weld	wEld
welfare	`wElfE@
well	wEl
wellbeing	`wElbi:IN
well-off	wEl-`Of
went	wEnt
wept	wEpt
were	w@:
weren't	w@:nt
west	wEst
western	`wEst@n
wet	wEt
whack	wAk
wharf	w@:f
what	wOt
whatever	wOt`Ev@
whatsoever	wOts@U`Ev@
wheat	wi:t
wheel	wi:l
	`wi:lbAr@U
wheelchair	`wi:ltSE@
when	wEn
whenever	wEn`Ev@
where	wE@
whereabouts	`wE@r@ba:Uts
whereas	wE@r`Az
wherever	wE@r`Ev@
whether	`wED@
which	wItS
whiff	wIf
while	wa:Il
whim	wIm
whimper	`wImp@
whine	wa:In
whinge	wIndZ
whip	wIp
whirl	w@:l
whirlwind	`w@:lwInd
whirr	w@:
whisk	wIsk
whisker	`wIsk@
whisky	`wIski:
whisper	`wIsp@
	`wIsl
white	wa:It
white ant	`wa:It Ant
white-ant	`wa:It Ant
white-out	`wa:Ita:Ut
whitewash	`wa:ItwOS
whiz	wIz
who	hu:
whoever	hu:`Ev@
whole	h@Ul
wholemeal	`h@Ulmi:l
wholesale	`h@UlsEIl
wholesome	`h@UlsV m
whom	hu:m
whopping	`wOpIN
whore	h@:
whose	hu:z
why	wa:I
wick	wIk
wicked	`wIk@d
wicket	`wIk@t
wide	wa:Id
widespread	`wa:IdsprEd
widow	`wId@U
widower	`wId@U@
wife	wa:If
wig	wIg
wiggle	`wIg@l
wild	wa:Ild
wilderness	`wIld@nEs
wild flower	`wa:Ildfla:U@
wildlife	`wa:Ildla:If
wilful	`wIlf@:l
will	wIl
willing	`wIlIN
willpower	`wIlpa:U@
wilt	wIlt
wily	`wa:Ili:
wimp	
win	wIn
wince	wIns
wind	wInd
window	`wInd@U
window shopping	`wInd@U ;SOpIN
windowsill	`wInd@UsIl
windpipe	`wIndpa:Ip
windscreen	`wIndskri:n
windsurf	`wInds@:f
windy	`wIndi:
wine	wa:In
wing	wIN
wink	wINk
winning	`wInIN
winter	`wInt@
wipe	wa:Ip
wire	`wa:I@
wiry	`wa:I@ri:
wisdom tooth	`wIzd@m tu:T
wise	wa:Iz
wish	wIS
wishy-washy	`wISi:-wOSi:
wit	wIt
witch	wItS
with	wIT
withdraw	wID`dr@:, wIT-
withhold	wID`h@Uld, wIT-
within	wID`In, wIT-
without	wID`a:Ut, wIT-
witness	`wItn@s
wizard	`wIz@d
wobble	`wOb@l
woe	w@U
woeful	`w@UfUl
wog	wOg
wok	wOk
woke	w@Uk
wolf	wUlf
woman	`wUm@n
womb	wu:m
wombat	`wOmbAt
won	wV n
wonder	`wV nd@
wonderful	`wV nd@fUl
wood	wUd
woodwork	`wUdw@:k
wool	wUl
word	w@:d
word processor	`w@:d pr@UsEs@
wore	w@:
work	w@:k
workbench	`w@:kbEntS
workforce	`w@:kf@:s
workload	`w@:kl@Ud
workout	`w@:ka:Ut
workplace	`w@:kplEIs
workshop	`w@:kSOp
world	w@:ld
worldwide	w@:l`dwa:Id
worm	w@:m
worn	w@:n
worn-out	w@:n-`a:Ut
worry	`wV ri:
worse	w@:s
worship	`w@:SIp
worst	w@:st
worth	w@:T
worthwhile	w@:T`wa:Il
worthy	`w@:Di:
would	wUd
wound	wa:Und
woven	`w@Uv@n
wow	wa:U
wowser	`wa:Uz@
wrap	rAp
wreath	ri:T
wreck	rEk
wrestle	`rEs@l
wretch	rEtS
wriggle	`rIgl
wring	rIN
wrinkle	`rINk@l
wrist	rIst
write	ra:It
write-off	`ra:It-@f
wrong	rON
wrote	r@Ut
wrung	rV N
wuss	wUs
X, x	Eks
x	Eks
Xmas	`krIsm@s, `Eksm@s
x-ray	`Eks-rEI, Eks-`rEI
Y, y	wa:I
y	wa:I
	jOt
yak	jAk
yakka	`jAk@
yank	jANk
yap	jAp
yard	ja:d
yarn	ja:n
yawn	j@:n
yd	ja:d
yeah	jE@
year	jI@
yeast	ji:st
yell	jEl
yellow	`jEl@U
yelp	jElp
yen	jEn
yes	jEs
yesterday	`jEst@dEI
yet	jEt
yield	ji:ld
yoga	`j@Ug@
yoghurt	`j@Ug@t, `jOg@t
yolk	j@Uk
yonks	jONks
you	ju:
young	jV N
youngster	`jV Nst@
your	j@:
yours	j@:z
yourself	j@:`sElf
youth	ju:T
yr	jI@
yuk	jV k
yuppie	`jV pi:
Z, z	zEd
zeal	zi:l
zero	`zI@r@U
zest	zEst
	`zIgzAg
zinc	zINk
	zIp
zodiac	`z@Udi:Ak
zombie	`zOmbi:
zone	z@Un
zoo	zu:
zoology	z@U`Ol@dZi:
zoom	zu:m
zucchini	z@`ki:ni:, zu:-
