-ish	-IS
a	EI
a.m.	EI`Em
abandon	@`bAnd@n
abbreviation	@bri:vi:`EIS@n
abc	EIbi:`si:
abdomen	`Abd@m@n
abide	@`ba:Id
ability	@`bIl@ti:
ablaze	@`blEIz
able	`EIb@l
abnormal	Ab`no:m@l
abnormality	Abno:`mAl@ti:
abolish	@`bOlIS
abominable	@`bOmn@b@l
aborigine	Ab@`rIdZ@ni:
abort	@`bo:t
abortion	@`bo:S@n
about	@`ba:Ut
above	@`bav
abrasion	@`brEIZ@n
abroad	@`bro:d
abrupt	@`brapt
abscess	`AbsEs
absent	`Abs@nt
absent-minded	Abs@nt-`ma:Ind@d
absolute	`Abs@lu:t
absorb	@b`so:b
abstract	`AbstrAkt
absurd	@b`s@:d
abuse	@`bju:z
academy	@k{d@mi:
accelerate	@k`sEl@rEIt
accent	`AksEnt
accept	@k`sEpt
access	`a:ksEs
accident	`Aks@d@nt
accommodate	@`kOm@dEIt
accompany	@`kamp@ni:
accomplice	@`kampl@s
accord	@`ko:d
accordingly	@`ko:dINli:
account	@`ka:u:nt
accountable	@`ka:Unt@b@l
accountant	@`ka:Unt@nt
accumulate	@`kju:mj@lEIt
accurate	`Akj@r@t
accuse	@`kju:z
accustomed	@`kast@md
ace	EIs
ache	EIk
achieve	@`tSi:v
acid	`As@d
acknowledge	@k`nOlIdZ
acne	`Akni:
acoustics	@`ku:stIks
acquaint	@`kwEInt
acquaintance	@`kwEInt@ns
acquire	@`kwa:I@
acquit	@`kwIt
acre	`EIk@
acrobat	`Akr@bAt
acronym	`Akr@nIm
across	@kr\Os
across-the-board	@`krOs-D@-bo:d
acrylic	@`krIlIk
act	EIsi:`ti:
action	`AkS@n
activate	`Akt@vEIt
active	`AktIv
activity	Ak`tIv@ti:
actor	`Akt@
actu	EIsi:ti:`ju:
actual	`AktSu:@l
actually	`AktSu:@li:
acupuncture	`Akj@paNktS@
acute	@`kju:t
acutely	@`kju:tli:
ad	EI`di:
adams apple	`Ad@mzAp@l
adapt	@`dApt
add	Ad
addict	`AdIkt
addicted	@`dIkt@d
addition	@`dIS@n
additive	`Ad@tIv
address	@`drEs
adequate	`Ad@kw@t
adhesive	@d`hi:.sIv
adjacent	@`dZEIs@nt
adjective	`AdZ@ktIv
adjourn	@`dZ@:n
adjudicate	@`dZu:d@kEIt
adjust	@`dZast
adjustment	@`dZastm@nt
admin	`AdmIn
administration	@dmIn@`strEIS@n
admire	@d`ma:I@
admission	@d`mIS@n
admit	@d`mIt
admittance	@d`mItns
adolescence	Ad@`lEs@ns
adopt	@`dOpt
adore	@`do:
adult	`Adalt
adultery	@`dalt@ri:
advance	@d`vAns
advanced	@d`vAnst
advancement	@d`vAnsm@nt
advantage	@d`vAntIdZ
adventure	@d`vEntS@
adverse	`Ad.v@:s
adversity	@d`v@:.s@ti:
advertise	`Ad.v@ta:Iz
advertisement	@d`v@:t@sm@nt
advice	@d`va:Is
advisable	@d`va:Iz@b@l
advise	@d`va:Iz
advocate	`Adv@kEIt
aerial	`E@.ri:@l
aerobics	E@`r@U.bIks
aerodrome	`E@r@dr@Um
aeroplane	`E@.r@plEIn
aerosol	`E@r@sOl
affair	@`fE@
affect	@`fEkt.
affectation	AfEk`tEI.S@n
affected	@`fEk.t@d
affection	@`fEk.S@n
affirm	@`f@:m.
affirmative	@`f@:.m@tIv
affluent	`Af.lu:@nt
afford	@`fo:d.
afloat	@`fl@Ut.
afraid	@`frEId.
after	`a:f.t@
after-effect	`a:ft@r-@fEkt
after-hours	`a:ft@r-a:U@z
afterlife	`a:ft@la:If
afternoon	a:ft@`nu:n
aftershave	`a:ft@SEIv
afterwards	`a:f.t@w@dz
again	@`gEn
against	@`gEnst
age	EIdZ
aged	EIdZd
ageing	`EIdZIN
ageism	`EIdZIz@m
agency	`EIdZ@nsi:
agenda	@`dZEnd@
agent	`EIdZ@nt
aggravate	`Agr@vEIt
aggression	@`grES@n
aggressive	@`grEsIv
aggro	`Agr@U
agile	`AdZa:Il
agitate	`AdZ@tEIt
agnostic	Ag`nOstIk
ago	@`g@U
agony	`Ag@ni:
agree	@`gri:
agreement	@`gri:m@nt
agriculture	`Agr@kaltS@
ahead	@`hEd
aid	EId
aids	EIdz
aim	EIm
aimless	`EIml@s
air	E@
air force	`E@fo:s
air raid	`E@rEId
air traffic control	;E@trAfIkk@n`tr@Ul
aircon	`E@kOn
airconditioning	`E@k@ndIS@nIN
aircraft	`E@kra:ft
aircraft carrier	`E@kra:ft`kAri:@
airlift	`E@lIft
airline	`E@la:In
airmail	`E@mEIl
airport	`E@po:t
aisle	a:Il
ajar	@`dZa:.
alarm	@`la:m
alarm clock	@`la:mklOk
alarmist	@`la:.m@st
album	`Alb@m
alcohol	`Alk@hOl
alcoholic	AlIk
ale	EIl
alert	@`l@:t
algebra	`AldZ@br@
alias	`EIli:@s
alibi	`Al@ba:I
alien	`EIli:@n
alienate	`EIli:@nEIt
alight	@`la:It
align	@`la:In
alike	@`la:Ik
alive	@`la:Iv
alkali	`Alk@la:I
all	o:l
all right	o:l`ra:It
allege	@`lEdZ
allegiance	@`li:dZ@ns
allegory	`Al@g@ri:
allergy	`Al@dZi:
alleviate	@`li:vi:EIt
alley	{li:
alliance	@`la:I@ns
allocate	`Al@kEIt
allot	@`lOt
allow	@`la:U
allowance	@`la:U@ns
allure	@`lu:@
ally	`Ala:I
almighty	o:l`ma:Iti:
almost	`o:lm@Ust
alone	@`l@Un
along	@lON
aloud	@`la:Ud
alp	EIEl`pi:
alphabet	`Alf@bEt
alpine	{lpAen
already	o:l`rEdi:
alright	o:l`ra:It
also	`o:ls@U
altar	`Olt@
alter	`Olt@
altercation	Olt@`kEIS@n
alternate	Ol`t@:n@t
alternative	Ol`t@:n@tIv
although	o:l`D@U
altitude	`Alt@tju:d
altogether	o:lt@`gED@
aluminium	Alj@`mInj@m
always	`o:lwEIz
am	EI`Em
ama	EIEm`EI
amalgamate	@`mAlg@mEIt
amass	@`mAs
amateur	`Am@t@
amaze	@`mEIz
ambassador	Am`bAs@d@
amber	`Amb@
ambiguous	Am`bIgju:@s
ambition	Am`bIS@n
amble	`Amb@l
ambulance	`Ambj@l@ns
ambush	`AmbUS
amenable	@`mEn@b@l
amend	@`mEnd
amenity	@`mEn@ti:
amiable	`EImi:@b@l
amicable	`AmIk@b@l
ammonia	@`m@Uni:@
ammunition	Amj@`nIS@n
amnesia	Am`ni:Z@
among	@`maN
amorous	`Am@r@s
amount	@`ma:Unt
ample	`Amp@l
amplify	`Ampl@fa:I
amputate	`Ampj@tEIt
amputee	;Ampju:`ti:
amuse	@`mju:z
amusement	@`mju:zm@nt
an	An
anaemia	@`ni:mi:@
anaesthetic	An@s`TEtIk
anal	`EI.n@l
analgesic	An@l`dZi:zIk
analogy	@`nAl@dZi:
analysis	@`nAl@s@s
anarchy	`An@ki:
anatomy	@`nAt@mi:
ancestor	`AnsEst@
anchor	`ANk@
anchorage	`ANk@rIdZ
ancient	`EInS@nt
and	And
anecdote	`An@kd@Ut
angel	`EIndZ@l
anger	`ANg@
angle	`ANg@l
angry	`ANgri:
anguish	`ANgwIS
animal	`An@m@l
animated	`An@mEIt@d
animosity	An@`mOs@ti:
ankle	`ANk@l
annex	`AnEks
annexe	`AnEks
annihilate	@`na:I@lEIt
anniversary	An@`v@:s@ri:
announce	@`na:Uns
annoy	@`no:I
annual	`Anju:@l
anonymous	@`nOn@m@s
another	@`naD@
answer	`Ans@
ant	Ant
antagonise	An`tAg@na:Iz
antagonistic	AntAg@`nIstIk
antenna	An`tEn@
anthem	`AnT@m
anthropologist	AnTr@`pOl@dZ@st
anti-	`Anti:
antibiotic	Anti:ba:I`OtIk
anticipate	An`tIs@pEIt
anticlockwise	Anti:`klOkwa:Iz
antics	`AntIks
antidote	`Anti:d@Ut
antihistamine	Anti:`hIst@mi:n
antipathy	An`tIp@Ti:
antipodes	An`tIp@di:z
antiquated	`Ant@kwEIt@d
antique	An`ti:k
antiseptic	Ant@`sEptIk
antithesis	An`tIT@s@s
antler	`Antl@
antonym	`Ant@nIm
anus	`EIn@s
anxious	`ANS@s
any	`Eni:
anybody	`Eni:bOdi:
anyhow	`Eni:ha:U
anyone	`Eni:wan
anything	`Eni:TIN
anyway	`Eni:wEI
anywhere	`Eni:wE@
anzac	`AnzAk
apart	@`pa:t
apartheid	@`pa:tEIt
apartment	@p6:tm@nt
apartments	@p6:tm@nts
apathy	`Ap@Ti:
ape	EIp
apex	`EIpEks
apocalypse	@`pOk@lIps
apologise	@`pOl@dZa:Iz
apology	@`pOl@dZi:
apostle	@`pOs@l
apostrophe	@`pOstr@fi:
appal	@`po:l
apparatus	Ap@`ra:t@s
apparent	@`pAr@nt
apparition	Ap@`rIS@n
appeal	@`pi:l
appear	@`pI@
appearance	@`pI@r@ns
appease	@`pi:z
append	@`pEnd
appendicitis	@pEnd@`sa:It@s
appendix	@`pEndIks
appetising	`Ap@ta:IzIN
appetite	`Ap@ta:It
applause	@`plo:z
apple	{p@l
appliance	@`pla:I@ns
applicable	@`plIk@b@l
applicant	`Apl@k@nt
apply	@`pla:I
appoint	@`po:Int
appointment	@`po:Intm@nt
appreciate	@`pri:Si:EIt
apprehend	Apr@`hEnd
apprehension	Apr@`hEnS@n
apprentice	@`prEnt@s
approach	@`pr@UtS
approachable	@`pr@UtS@b@l
appropriate	@`pr@Upri:@t
approval	@`pru:v@l
approve	@`pru:v
approximate	@`prOks@m@t
apr.	`EIpr@l
april	`EIpr@l
apron	`EIpr@n
apt	Apt
aptitude	`Apt@tSu:d
aquarium	@`kwE@ri:@m
arabic	`Ar@bIk
arbitrary	`a:b@tr@ri:
arbitration	a:b@`trEIS@n
arc	a:k
arcade	a:`kEId
arch	a:tS
archaeologist	a:ki:`Ol@dZ@st
archaic	a:`kEIIk
architect	`a:k@tEkt
arctic circle	a:ktIk`s@:k@l
arduous	`a:dZu:@s
are	a:
area	e:r\i:@
arena	@r\i:n@
arguable	`a:gju:@b@l
argue	`a:gju:
argument	`a:gj@m@nt
arise	@`ra:Iz
aristocracy	Ar@`stOkr@si:
arithmetic	@`rITm@tIk
ark	a:k
arm	a:m
armchair	`a:mtSE@
armed	a:md
armful	`a:mfUl
armhole	`a:mh@Ul
armistice	`a:m@st@s
armour	`a:m@
armpit	`a:mpIt
army	`a:mi:
aroma	@`r@Um@
around	@`ra:Und
arousal	@`ra:Uz@l
arouse	@`ra:Uz
arrange	@`rEIndZ
arrangement	@`rEIndZm@nt
array	@`rEI
arrest	@`rEst
arrival	@`ra:Iv@l
arrive	@`ra:Iv
arrogant	`Ar@g@nt
arrow	`Ar@U
arse	a:s
arsenal	`a:s@n@l
arsenic	`a:s@nIk
arson	`a:s@n
art	a:t
art union	`a:tju:nj@n
artery	`a:t@ri:
arthritis	a:`Tra:It@s
article	`a:tIk@l
artificial	a:t@`fIS@l
artist	`a:t@st
arvo	`a:v@U
as	Az
asbestos	@s`bEst@s
ascend	@`sEnd
ascent	@`sEnt
ascertain	As@`tEIn
ash	AS
ashamed	@`SEImd
aside	@`sa:Id
ask	a:sk
asleep	@`sli:p
asparagus	@`spAr@g@s
aspect	`As.pEkt
asphalt	`ASfElt
aspire	@`spa:I@
aspirin	`Aspr@n
ass	As
assassin	@`sAs@n
assassinate	@`sAs@nEIt
assault	@`sOlt
assemble	@`sEmb@l
assembly	@`sEmbli:
assent	@`sEnt
assert	@`s@:t
assertive	@`s@:tIv
assess	@`sEs
asset	`As@t
assign	@`sa:In
assignment	@`sa:Inm@nt
assimilate	@`sIm@lEIt
assist	@`sIst
associate	@`s@USi:EIt
association	@s@Usi:`EIS@n
assortment	@`so:tm@nt
assume	@`sju:m
assurance	@`So:r@ns
assure	@`So:
asterisk	`Ast@rIsk
asthma	`a:sm@
astonish	@`stOnIS
astound	@`sta:Und
astray	@`strEI
astrology	@s`trOl@dZi:
astronaut	`Astr@no:t
astronomy	@s`trOn@mi:
astute	@s`tju:t
asylum	@`sa:Il@m
at	At
ate	EIt
atheist	`EITi:@st
athlete	`ATli:t
atlas	`Atl@s
atm	EIti:`Em
atmosphere	`Atm@sfI@
atom	`At@m
atomic	@`tOmIk
atrocious	@`tr@US@s
attach	@`tAtS
attack	@`tAk
attain	@`tEIn
attempt	@`tEmpt
attend	@`tEnd
attention	@`tEnS@n
attic	`AtIk
attire	@`ta:I@
attitude	`At@tju:d
attract	@`trAkt
attractive	@`trAktIv
attribute	@`trIbju:t
atypical	EI`tIpIk@l
aubergine	`@Ub@dZi:n
auburn	`o:b@n
auction	`OkS@n
audacious	o:`dEIS@s
audible	`o:d@b@l
audience	`o:di:@ns
audio	`o:di:@U
audit	`o:d@t
audition	o:`dIS@n
aug.	`o:g@st
august	o:`gast
aunt	a:nt
aura	`o:r@
auspicious	o:`spIS@s
austere	Os`tI@
australia	@str\{Ili:@
australian	@st`rEIlj@n
australian democrats	@strEIlj@n`dEm@krAts
australian labor party	@strEIlj@n`lEIb@pa:ti:
authentic	o:`TEntIk
author	`o:T@
authorise	`o:T@ra:Iz
authority	o:`TOr@ti:
autobiography	o:t@ba:I`Ogr@fi:
autograph	`o:t@grAf
automatic	o:t@`mAtIk
automobile	`o:t@m@bi:l
autonomous	o:`tOn@m@s
autopsy	`o:tOpsi:
autumn	`o:t@m
auxiliary	Og`zIlj@ri:
avail	@`vEIl
available	@`vEIl@b@l
avalanche	`Av@lAnS
ave	`Av@nju:
avenge	@`vEndZ
avenue	{v@nj}:
average	`Av@rIdZ
averse	@`v@:s
aversion	@`v@:Z@n
avert	@`v@:t
aviation	EIvi:`EIS@n
avid	`Av@d
avocado	Av@`ka:d@U
avoid	@`vo:Id
await	@`wEIt
awake	@`wEIk
awaken	@`wEIk@n
award	@`wo:d
aware	@`wE@
away	@`wEI
awe	o:
awful	`o:f@l
awhile	@`wa:Il
awkward	`o:kw@d
awning	`o:nIN
axe	Aks
axis	`Aks@s
axle	`Aks@l
b	bi:
babble	`bAbl
baby	`bEIbi:
babysit	`bEIbi:sIt
bachelor	`bAtS@l@
back	b{k
backbone	`bAkb@Un
backdate	`bAkdEIt
backfire	bAk`fa:I@
background	`bAkgra:Und
backing	`bAkIN
backlog	`bAklOg
backside	bAk`sa:Id
backstop	`bAkstOp
backstroke	`bAkstr@Uk
backup	`bAkap
backward	`bAkw@d
backwards	`bAkw@dz
backyard	bAk`ja:d
bacon	`bEIk@n
bacteria	bAk`tI@ri:@
bad	bAd
bade	bAd
badge	bAdZ
badger	`bAdZ@
baffle	`bAfl
bag	bAg
baggage	`bAgIdZ
bahasa indonesia	b@ha:s@Ind@`ni:Z@
bail	bEIl
bait	bEIt
bake	bEIk
baking powder	`bEIkINpa:Ud@
baking soda	`bEIkINs@Ud@
balance	`bAl@ns
balanced	`bAl@nst
balcony	`bAlk@ni:
bald	bo:ld
bale	bEIl
ballast	`bAl@st
ballet	`bAlEI
ballot	`bAl@t
ballpoint pen	bo:lpo:Int`pEn
balmy	`ba:mi:
bamboozle	bAm`bu:zl
ban	bAn
band	bAnd
bandaid	`bAndEId
bandicoot	`bAndi:ku:t
bandit	`bAnd@t
bang	bAN
banjo	`bAndZ@U
bank	b{Nk
bankrupt	`bANkrapt
banksia	`bANksi:@
banner	`bAn@
banquet	`bANkw@t
baptism	`bAptIzm
bar	b6:
bar code	`ba:k@Ud
barb	ba:b
barbarian	ba:`bE@ri:@n
barbecue	`ba:b@kju:
barber	`ba:b@
barbiturate	ba:`bItSUr@t
bare	bE@
barely	`bE@li:
bargain	`ba:g@n
barge	ba:dZ
baritone	`bAr@t@Un
bark	ba:k
barn	ba:n
barometer	b@`rOm@t@
barrack	`bAr@k
barracks	`bAr@ks
barrage	`bAra:Z
barrel	`bAr@l
barren	`bAr@n
barrier	`bAri:@
barrister	`bAr@st@
barrow	`bAr@U
base	bEIs
baseball	`bEIsbo:l
basement	`bEIsm@nt
bash	bAS
bashful	`bASfUl
basic	`bEIsIk
basin	`bEIs@n
basis	`bEIs@s
bask	ba:sk
basket	`ba:sk@t
basketball	`ba:sk@tbo:l
bass	bEIs
bassinette	bAs@`nEt
bastard	`ba:st@d
bat	bAt
batch	bAtS
bath	ba:T
bathe	bEID
bathers	`bEID@z
bathroom	`ba:Tru:m
baton	`bAtn
battalion	b@`tAlj@n
batten	`bAtn
batter	`bAt@
battle	b{t@l
baulk	bo:k
bawdy	`bo:di:
bawl	bo:l
bay	bEI
bayonet	`bEI@nEt
bbq	`rba:.b@kju:
bc	bi:`si:
be	bi:
beach	bi:tS
beach inspector	`bi:tSInspEkt@
beacon	`bi:k@n
bead	bi:d
beak	bi:k
beam	bi:m
bean	bi:n
bear	bE@
beard	bI@d
bearing	`bE@rIN
beast	bi:st
beat	bi:t
beaut	bju:t
beautician	bju:`tIS@n
beautiful	`bju:t@f@l
beauty	`bju:ti:
became	b@`kEIm
because	bi:`ko:z
beckon	`bEk@n
become	b@`kam
becoming	b@`kamIN
bed	bEd
bedding	`bEdIN
bedraggled	b@`drAg@ld
bedridden	`bEdrIdn
bedroom	`bEdru:m
bee	bi:
beef	bi:f
been	bi:n
beer	bI@
before	b@`fo:
befriend	b@`frEnd
beg	bEg
began	b@`gAn
begin	b@`gIn
beginner	b@`gIn@
begrudge	b@`gradZ
begun	b@`gan
behalf	b@`ha:f
behave	b@`hEIv
behind	b@`ha:Ind
beige	bEIZ
being	`bi:IN
belated	b@`lEIt@d
belch	bEltS
belief	b@`li:f
believe	b@`li:v
belittle	b@`lItl
bell	bEl
belligerent	b@`lIdZ@r@nt
bellow	`bEl@U
belly	`bEli:
bellybutton	`bEli:bat@n
belong	b@`lON
belongings	b@`lONINz
beloved	b@`lav@d
below	b@`l@U
belt	bElt
bench	bEntS
bend	bEnd
beneath	b@`ni:T
benefactor	`bEn@fAkt@
beneficial	bEn@`fIS@l
beneficiary	bEn@`fIS@ri:
benefit	`bEn@f@t
benevolent	b@`nEv@l@nt
benign	b@`na:In
bent	bEnt
bequeath	b@`kwi:D
bereaved	b@`ri:vd
bereft	b@`rEft
beret	`bErEI
berry	`bEri:
berserk	b@`z@:k
berth	b@:T
beside	b@`sa:Id
besides	b@`sa:Idz
besiege	b@`si:dZ.
best	bEst
best man	bEst`mAn
bet	bEt
betray	b@`trEI
better	`bEt@
between	b@`twi:n
beverage	`bEvrIdZ
beware	b@`wE@
bewildered	b@`wIld@d
bewitch	b@`wItS
beyond	b@`jOnd
biannual	ba:I`Anju:@l
bias	`ba:I@s
bib	bIb
bible	`ba:Ib@l
bibliography	bIbli:`@gr@fi:
bicentenary	ba:IsEn`ti:n@ri:
bicentennial	ba:Is@n`tEni:@l
biceps	`ba:Is@ps
bicker	`bIk@
bicycle	`ba:IsIk@l
bid	bId
bide	ba:Id
biennial	ba:I`Eni:@l
bifocals	ba:I`f@Uk@lz
big	bIg
bigamy	`bIg@mi:
biggie	`bIgi:
bight	ba:It
bigot	`bIg@t
bike	ba:Ik
bikini	b@`ki:ni:
bile	ba:Il
bilingual	ba:I`lINgw@l
bilious	`bIlj@s
bill	bIl
billabong	`bIl@bON
billboard	`bIlbo:d
billet	`bIl@t
billiards	`bIlj@dz
billion	`bIlj@n
billow	`bIl@U
billy	`bIli:
bin	bIn
bind	ba:Ind
bindi-eye	`bIndi:-a:I
bingo	`bINg@U
binoculars	b@`nOkj@l@z
biodegradable	ba:I@Ud@`grEId@b@l
biography	ba:I`Ogr@fi:
biologist	ba:I`Ol@dZ@st
biopsy	`ba:IOpsi:
bird	b@:d
biro	`ba:Ir@U
birth	b@:T
birthday	`b@:TdEI
biscuit	`bIsk@t
bisect	ba:I`sEkt
bisexual	ba:I`sEkSu:@l
bishop	`bIS@p
bistro	`bIstr@U
bit	bIt
bitch	bItS
bite	ba:It
bitter	`bIt@
bitumen	`bItS@m@n
bivouac	`bIvu:Ak
bizarre	b@`za:
blab	blAb
black	blAk
black sheep	blAk`Si:p
blackboard	`blAkbo:d
blackhead	`blAkhEd
blackmail	`blAkmEIl
blackout	`blAka:Ut
blacksmith	`blAksmIT
bladder	`blAd@
blade	blEId
blame	blEIm
bland	blAnd
blank	blANk
blanket	`bla:Nk@t
blare	blE@
blaspheme	blAs`fi:m
blast	bla:st
blatant	`blEIt@nt
blaze	blEIz
blazer	`blEIz@
bleach	bli:tS
bleak	bli:k
bleary	`blI@ri:
bleat	bli:t
bleed	bli:d
blemish	`blEmIS
blend	blEnd
blender	`blEnd@
bless	blEs
blessing	`blEsIN
blew	blu:
blight	bla:It
blind	bla:Ind
blindfold	`bla:Indf@Uld
blink	blINk
blinker	`blINk@
bliss	blIs
blister	`blIst@
blistering	`blIst@rIN
blitz	blIts
blizzard	`blIz@d
bloated	`bl@Ut@d
bloc	blOk
block	blOk
blockade	blO`kEId
blockbuster	`blOkbast@
bloke	bl@Uk
blond	blOnd
blonde	blOnd
blood	blad
bloodbath	`bladba:T
bloodshed	`bladSEd
bloodshot	`bladSOt
bloodstream	`bladstri:m
bloodthirsty	`bladT@:sti:
bloody	`bladi:
bloody-minded	bladi:-`ma:Ind@d
bloom	blu:m
blossom	`blOs@m
blot	blOt
blouse	bla:Uz
blow	bl@U
blowout	`bl@Ua:Ut
blowtorch	`bl@Uto:tS
blubber	`blab@
bludge	bladZ
bludgeon	`bladZ@n
blue	bl}:
blue metal	`blu:mEtl
blue movie	blu:`mu:vi:
blue-collar	`blu:-kOl@
blue-ringed octopus	;blu:-rINd`Okt@p@s
bluebird	bl}:b3:d
bluebottle	`blu:bOtl
blueprint	`blu:prInt
blues	blu:z
bluff	blaf
blunder	`bland@
blunt	blant
blur	bl@:
blurb	bl@:b
blurt	bl@:t
blush	blaS
bluster	`blast@
bmx	bi:Em`Eks
board	bo:d
boarder	`bo:d@
boast	b@Ust
boat	b@Ut
boat people	`b@Utpi:p@l
bob	bOb
bobbin	`bOb@n
bobby pin	`bObi:pIn
bodice	`bOd@s
body	`bOdi:
bodyguard	`bOdi:ga:d
bog	bOg
bogus	`b@Ug@s
bogy	`b@Ugi:
boil	bo:Il
boiler	`bo:Il@
boilersuit	`bo:Il@su:t
boisterous	`bo:Istr@s
bold	b@Uld
bolster	`b@Ulst@
bolt	b@Ult
bomb	bOm
bombard	bOm`ba:d
bombshell	`bOmSEl
bona fide	b@Un@`fa:Idi:
bond	bOnd
bone	b@Un
bonfire	`bOnfa:I@
bongo	`bONg@U
bonnet	`bOn@t
bonus	`b@Un@s
boob	bu:b
boobook	`bu:bUk
booby prize	`bu:bi:pra:Iz
booby trap	`bu:bi:trAp
book	bUk
bookcase	`bUkkEIs
bookkeeping	`bUkki:pIN
bookmaker	`bUkmEIk@
bookstall	`bUksto:l
bookworm	`bUkw@:m
boom	bu:m
boomer	`bu:m@
boomerang	`bu:m@rAN
boon	bu:n
boor	bo:
boost	bu:st
boot	bu:t
booth	bu:D
booty	`bu:ti:
booze	bu:z
border	`bo:d@
borderline	`bo:d@la:In
bore	bo:
born	bo:n
borne	bo:n
boronia	b@`r@Uni:@
borough	`bar@
borrow	`bOr@U
bosom	`bUz@m
boss	bOs
botanist	`bOt@n@st
botch	bOtS
both	b@UT
bother	`bOD@
bottle	`bOtl
bottlebrush	`bOtlbraS
bottleneck	`bOtlnEk
bottom	`bOt@m
bough	ba:U
bought	bo:t
boulder	`b@Uld@
boulevard	`bu:l@va:d
bounce	ba:Uns
bouncing	`ba:UnsIN
bouncy	`ba:Unsi:
bound	ba:Und
boundary	`ba:Undri:
bounty	`ba:Unti:
bouquet	bu:`kEI
bourgeois	`bU@Zwa:
bout	ba:Ut
boutique	bu:`ti:k
bow	b@U
bowel	`ba:U@l
bowerbird	`ba:U@b@:d
bowl	b@Ul
bowling	`b@UlIN
bowls	b@Ulz
bowser	`ba:Uz@
box	bOks
box jellyfish	bOks`dZEli:fIS
box office	`bOksOf@s
boxer	`bOks@
boy	boI
boycott	`bo:IkOt
boyfriend	`bo:IfrEnd
bra	bra:
brace	brEIs
bracelet	`brEIsl@t
bracken	`brAk@n
bracket	`brAk@t
brag	brAg
braid	brEId
braille	brEIl
brain	brEIn
brainstorm	`brEInsto:m
brainwash	`brEInwOS
brainwave	`brEInwEIv
braise	brEIz
brake	brEIk
bran	brAn
branch	brAntS
brand	brAnd
brash	brAS
brass	bra:s
brassiere	`brAzi:@
brat	brAt
bravado	br@`va:d@U
brave	brEIv
brawl	bro:l
brawn	bro:n
brazen	`brEIz@n
breach	bri:tS
bread	brEd
bread-and-butter	brEd-@n-`bat@
breadline	`brEdla:In
breadth	brEdT
breadwinner	`brEdwIn@
break	brEIk
break-in	`brEIk-In
breakable	`brEIk@b@l
breakdown	`brEIkda:Un
breakfast	`brEkf@st
breakthrough	`brEIkTru:
bream	brIm
breast	brEst
breaststroke	`brEststr@Uk
breath	brET
breath test	`brETtEst
breathalyser	`brET@la:Iz@
breathe	bri:D
breathtaking	`brETtEIkIN
breed	bri:d
breeze	bri:z
breezy	`bri:zi:
brevity	`brEv@ti:
brew	bru:
brewery	`bru:@ri:
bribe	bra:Ib
brick	brIk
brick-veneer	brIk-v@`nI@
brickie	`brIki:
bricklayer	`brIklEI@
bride	bra:Id
bridegroom	`bra:Idgru:m
bridesmaid	`bra:IdzmEId
bridge	brIdZ
bridle	`bra:Idl
brief	bri:f
briefcase	`bri:fkEIs
bright	bra:It
brilliant	`brIlj@nt
brim	brIm
brine	bra:In
bring	brIN
brink	brINk
brisk	brIsk
bristle	`brIsl
brittle	`brItl
broach	br@UtS
broad	bro:d
broad-minded	bro:d-`ma:Ind@d
broadcast	`bro:dka:st
broccoli	`brOk@li:
brochure	`br@US@
broke	br@Uk
broken	`br@Uk@n
broker	`br@Uk@
brolga	`brOl.g@
brolly	`brOli:
bronchitis	brON`ka:It@s
bronze	brOnz
brooch	br@UtS
brood	bru:d
broom	bru:m
bros.	`braD@z
broth	brOT
brothel	`brOT@l
brother	`braD@
brother-in-law	`braD@r-In-lo:
brought	bro:t
brow	bra:U
browbeat	`bra:Ubi:t
brown	bra:Un
browse	bra:Uz
bruise	bru:z
brumby	`brambi:
brunch	brantS
brunette	bru:`nEt
brunt	brant
brush	braS
brussels sprout	bras@lz`spra:Ut
brutal	`bru:t@l
brute	bru:t
bubble	`bab@l
bubbler	`babl@
buck	bak
bucket	`bak@t
buckle	`bakl
bucktooth	bak`tu:T
bud	bad
buddhism	`bUdIz@m
buddy	`badi:
budge	badZ
budgerigar	`badZ@ri:ga:
budget	`badZ@t
budgie	`badZi:
buff	baf
buffer	`baf@
buffet	`bafEI
buffoon	b@`fu:n
bug	bag
bugbear	`bagbE@
bugger	`bag@
bugle	`bju:g@l
build	bIld
building	bIldIN
building society	`bIldINs@sa:I@ti:
built-up area	bIlt-ap`E@ri:@
bulb	balb
bulge	baldZ
bulk	balk
bull	bUl
bullbar	`bUlba:
bulldozer	`bUld@Uz@
bullet	`bUl@t
bulletin	`bUl@t@n
bullion	`bUlj@n
bullock	`bUl@k
bullseye	`bUlza:I
bullshit	`bUlSIt
bully	`bUli:
bum	bam
bumble	`bamb@l
bump	bamp
bumper	`bamp@
bun	ban
bunch	bantS
bundle	`bandl
bundy	`bandi:
bung	baN
bungalow	`baNg@l@U
bungle	`baNg@l
bunion	`banj@n
bunk	baNk
bunker	`baNk@
bunny	`bani:
bunyip	`banj@p
buoy	bo:I
buoyant	`bo:I@nt
burble	`b@:b@l
burden	`b@:dn
bureau	`bju:r@U
bureaucracy	bju:`rOkr@si:
bureaucrat	`bju:r@krAt
burglar	`b@:gl@
burial	`bEri:@l
burl	b@:l
burly	`b@:li:
burn	b@:n
burnish	`b@:nIS
burp	b@:p
burr	b@:
burrow	`bar@U
bursar	`b@:s@
bursary	`b@:s@ri:
burst	b@:st
bury	`bEri:
bus	bas
bush	bUS
bush band	`bUSbAnd
bushed	bUSt
bushfire	`bUSfa:I@
bushie	`bUSi:
bushman	`bUSm@n
bushranger	`bUSrEIndZ@
bushwalk	`bUSwo:k
bushwhacker	`bUSwAk@
business	`bIzn@s
businesslike	`bIzn@sla:Ik
busker	`bask@
bust	bast
bustard	`bast@d
bustle	`bas@l
busy	`bIzi:
busybody	`bIzi:bOdi:
but	bat
butane	`bju:tEIn
butch	bUtS
butcher	`bUtS@
butcherbird	`bUtS@b@:d
butt	bat
butter	`bat@
butterfly stroke	`bat@fla:Istr@Uk
buttocks	`bat@ks
button	b6t@n
buttress	`batr@s
buy	ba:I
buzz	baz
by	ba:I
by-election	`ba:I-@lEkS@n
by-law	`ba:I-lo:
by-product	`ba:I-prOdakt
bye	ba:I
byo	bi:wa:I`@U
bypass	`ba:Ipa:s
bystander	`ba:IstAnd@
byte	ba:It
byword	`ba:Iw@:d
c	si:
c/o	`kE@.rOv
cab	kAb
cabbage	`kA.bIdZ
cabin	`kA.b@n
cabinet	`kA.b@n@t
cable	`kEI.b@l
cackle	`kA.k@l
cadet	k@`dEt.
cadge	kAdZ
caesarean section	s@;zE@ri:@n`sEkS.@n
cafe	`kA.fEI
cafeteria	kAf@`tI@.ri:@
café	k{f{I
cage	kEIdZ
cagey	`kEI.dZi:
cake	kEIk
calamari	kAl@`ma:.ri:
calamity	k@`lA.m@ti:
calcium	`kAl.si:@m
calculate	`kAl.kj@lEIt
calculating	`kAl.kj@lEItIN
calculator	`kAl.kj@lEIt@
calendar	`kA.l@nd@
calf	ka:f
call	ko:l
callgirl	`ko:l.g@:l
callous	`kA.l@s
calm	ka:m
calorie	`kA.l@ri:
came	kEIm
camera	`kAm.r@
camouflage	`kA.m@fla:Z
camp	kAmp
campaign	kAm`pEIn.
campus	`kAm.p@s
can	kAn
canal	k@`nAl.
cancel	`kAn.s@l
cancer	`kAn.s@
candid	`kAn.d@d
candidate	`kAn.d@dEIt
candle	`kAnd.l
candour	`kAn.d@
cane	kEIn
cane toad	`kEIn.t@Ud
canine	`kEI.na:In
cannabis	`kA.n@b@s
cannon	`kA.n@n
cannot	`kA.nOt
canoe	k@`nu:.
canopy	`kA.n@pi:
cant	ka:nt
canteen	kAn`ti:n.
canter	`kAn.t@
cantonese	kAnt@`ni:z.
canvas	`kAn.v@s
canyon	`kA.nj@n
cap	kAp
capable	`kEI.p@b@l
capacity	k@`pA.s@ti:
cape	kEIp
capital	k{p@t@l
capitalise	`kA.p@t@la:Iz
capitalism	`kA.p@t@lIz@m
capsicum	`kAp.s@k@m
capsize	kAp`sa:Iz.
capsule	`kAp.Su:l
captain	`kAp.t@n
caption	`kAp.S@n
captivate	`kAp.t@vEIt
captive	`kAp.tIv
captivity	kAp`tI.v@ti:
capture	`kAp.tS@
car	ka:
car park	`ka:.pa:k
carafe	k@`ra:f.
caramel	`kA.r@m@l
carat	`kA.r@t
caravan	`kA.r@vAn
carbohydrate	ka:b@`ha:I.drEIt
carbon	`ka:.b@n
carburettor	ka:bj@`rE.t@
carcass	`ka:.k@s
carcinogen	ka:.`sIn@dZ@n
card	ka:d
cardboard	`ka:d.bo:d
cardiac	`ka:.di:Ak
cardigan	`ka:.dIg@n
cardinal number	ka:d@n@l`nam.b@
care	kE@
career	k@`rI@.
careful	`kE@.f@l
careless	`kE@.l@s
caress	k@`rEs.
caretaker	`kE@.tEIk@
cargo	`ka:.g@U
caricature	`kA.r@k@tSU@
carnage	`ka:.nIdZ
carnival	`ka:.n@v@l
carol	`kA.r@l
carpenter	`ka:.p@nt@
carpet	`ka:.p@t
carriage	`kA.rIdZ
carry	`kA.ri:
cart	ka:t
cartilage	`ka:.t@lIdZ
carton	`ka:t.n
cartoon	ka:`tu:n.
cartridge	`ka:.trIdZ
carts	k6:ts
carve	ka:v
case	kEIs
cash	kAS
cashier	k{SI@
casino	k@`si:.n@U
cask	ka:sk
casserole	`kA.s@r@Ul
cassette	k@`sEt.
cast	ka:st
caste	ka:st
castle	k6:s@l
castor	`ka:.st@
castrate	`kAs.trEIt
casual	`kA.Zju:@l
casualty	`kA.Zju:@lti:
casuarina	kAZj@`ri:.n@
cat	kAt
catalogue	`kA.t@lOg
catapult	`kA.t@palt
cataract	`kA.t@rAkt
catarrh	k@`ta:.
catastrophe	k@`tAs.tr@fi:
catch	kAtS
category	`kA.t@g@ri:
cater	`kEI.t@
cathedral	k@`Ti:dr@l
cattle	`kAt.l
caucus	`ko:.k@s
caught	ko:t
cauliflower	`kO.li:fla:U@
cause	ko:z
causeway	`ko:z.wEI
caustic	`kOs.tIk
cauterise	`ko:.t@ra:Iz
cautious	`ko:.S@s
cavalry	`kA.v@lri:
cave	kEIv
cavern	`kA.v@n
cavity	`kA.v@ti:
cd	si:`di:.
cease	si:s
ceasefire	`si:s.fa:I@
ceiling	`si:.lIN
celebrate	`sE.l@brEIt
celebrated	`sE.l@brEIt@d
celebrity	s@`lE.br@ti:
celery	`sE.l@ri:
celibacy	`sE.l@b@si:
cell	sEl
cellar	`sE.l@
celsius	`sEl.si:@s
cement	s@`mEnt.
cemetery	`sE.m@tri:
censor	`sEn.s@
censure	`sEn.S@
census	`sEn.s@s
cent	sEnt
centenary	sEn`ti:.n@ri:
centigrade	`sEn.t@grEId
centimetre	`sEn.t@mi:t@
central	`sEn.tr@l
centre	`sEn.t@
century	`sEn.tS@ri:
ceramic	s@`rA.mIk
cereal	`sI@.ri:@l
cerebral	`sE.r@br@l
ceremony	`sE.r@m@ni:
certain	`s@:t.n
certainly	`s@:.tnli:
certificate	s@`tI.fIk@t
certify	`s@:.t@fa:I
cervix	`s@:.vIks
ces	si:i:`Es.
chafe	tSEIf
chain	tSEIn
chainsaw	`tSEIn.so:
chair	tSE@
chairman	`tSE@.m@n
chairperson	`tSE@.p@:sn
chalk	tSo:k
challenge	`tSA.l@ndZ
chamber	`tSEIm.b@
chamois	`SA.mi:
champion	`tSAm.pj@n
chance	tSAns
change	tSEIndZ
channel	`tSA.n@l
chant	tSAnt
chaos	`kEI.Os
chap	tSAp
chapel	`tSA.p@l
chapped	tSApt
chapter	`tSAp.t@
character	`kA.r@kt@
characteristic	kAr@kt@`rI.stIk
charade	S@`ra:d.
charcoal	`tSa:.k@Ul
charge	tSa:dZ
charisma	k@`rIz.m@
charity	`tSA.r@ti:
charm	tSa:m
chart	tSa:t
charter	`tSa:.t@
chase	tSEIs
chassis	`SA.zi:
chat	tSAt
chatter	`tSA.t@
chauffeur	`S@U.f@
chauvinism	`S@U.v@nIz@m
cheap	tSi:p
cheat	tSi:t
check	tSEk
check-up	`tSEk.-ap
checkout	`tSEk.a:Ut
cheek	tSi:k
cheer	tSI@
cheerful	`tSI@.fUl
cheese	tSi:z
chef	SEf
chemical	`kE.mIk@l
chemist	`kE.m@st
chemistry	`kE.m@stri:
chemotherapy	kEm@U`TE.r@pi:
cheque	tSEk
chequebook	`tSEk.bUk
cherish	`tSE.rIS
cherub	`tSE.r@b
chess	tSEs
chest	tSEst
chew	tSu:
chewing gum	`tSu:.INgam
chic	Si:k
chick	tSIk
chicken	`tSI.k@n
chickenpox	`tSI.k@npOks
chief	tSi:f
child	tSa:Ild
childish	`tSa:IldIS
chill	tSIl
chilli	`tSIli:
chime	tISa:Im
chimney	tSImni:
chin	tSIn
china	`tSa:In@
chinese	`tSa:Ini:z
chip	tSIp
chipboard	`tSIpbo:d
chiropractor	`ka:Ir@prAkt@
chirp	tS@:p
chirpy	`tS@:pi:
chisel	`tSIz@l
chlorine	`klo:ri:n
chocolate	`tSOkl@t
choice	tSo:Is
choir	`kwa:I@
choke	tS@Uk
cholera	`kOl@r@
cholesterol	k@`lEst@rOl
chook	tSUk
choose	tSu:z
chop	tSOp
choppy	`tSOpi:
chopsticks	`tSOpstIks
chord	ko:d
chore	tSo:
choreographer	kOri:`Ogr@f@
chorus	`ko:r@s
chose	tS@Uz
chosen	`tS@Uz@n
christen	`krIs@n
christianity	krIsti:`An@ti:
christmas	`krIsm@s
christmas bush	`krIsm@sbUS
chrome	kr@Um
chronic	`krOnIk
chronological	krOn@`lOdZIk@l
chubby	`tSabi:
chuck	tSak
chuckle	`tSak@l
chunder	`tSand@
chunk	tSaNk
church	tS3:tS
churn	tS@:n
chute	Su:t
chutney	`tSatni:
cider	`sa:Id@
cigar	s@`ga:
cigarette	sIg@`rEt
cinema	`sIn@m@
circle	`s@:k@l
circuit	`s@:k@t
circulate	`s@:kj@lEIt
circulation	s@:kj@`lEIS@n
circumcise	`s@:.k@msa:Iz
circumference	s@`kamf@r@ns
circumstance	`sEk@mstAns
circus	`s@:k@s
citizen	`sIt@z@n
citrus	`sItr@s
city	sIti:
civic	`sIvIk
civil	`sIv@l
civilian	s@`vIlj@n
civilisation	sIv@la:I`zEIS@n
civilised	`sI.v@la:Izd
cl.	kl@Us
claim	klEIm
clairvoyant	klE@`vo:I.@nt
clam	klAm
clamber	`klAm.b@
clammy	`klAmi:
clamour	`klA.m@
clamp	klAmp
clan	klAn
clandestine	`klAn.d@sta:In
clang	klAN
clanger	`klAN.@
clap	klAp
clarify	`klA.r@fa:I
clarity	`klA.r@ti:
clark	kl6:k
clash	klAS
clasp	klAsp
class	kla:s
classic	`klA.sIk
classify	`klA.s@fa:I
classroom	`kla:s.rUm
clatter	`klA.t@
clause	klo:z
claustrophobia	klOstr@`f@U.bi:@
claw	klo:
clay	klEI
clean	kli:n
clear	klI@
clearance	`klI@.r@ns
clearing	`klI@.rIN
clearway	`klI@.wEI
clench	klEntS
clergy	`kl@:.dZi:
clerk	kla:k
clever	`klE.v@
clich;aae	`kli:.SEI
click	klIk
client	`kla:I.@nt
cliff	klIf
climate	`kla:I.m@t
climax	`kla:I.mAks
climb	kla:Im
clinch	klIntS
cling	klIN
clinic	`klI.nIk
clip	klIp
cloak	kl@Uk
clock	klOk
clockwise	`klOk.wa:Iz
clockwork	`klOk.w@:k
clog	klOg
clone	kl@Un
close	kl@Uz
close-up	`kl@Us.-ap
clot	klOt
cloth	klOT
clothe	kl@UD
clothes	kl@UDz
clothing	`kl@U.DIN
cloud	kla:Ud
cloudy	`kla:U.di:
clout	kla:Ut
clover	`kl@U.v@
clown	kla:Un
club	klab
clucky	`kla.ki:
clue	klu:
clump	klamp
clumsy	`klam.zi:
clung	klaN
cluster	`klas.t@
clutch	klatS
clutter	`kla.t@
cm	`sEn.t@mi:t@
co	`kam.p@ni:
coach	k@UtS
coagulate	k@U`A.gj@lEIt
coal	k@Ul
coalition	k@U@`lI.S@n
coarse	ko:s
coast	k@Ust
coastline	`k@Ust.la:In
coat	k@Ut
coathanger	`k@Ut.hAN@
coating	`k@U.tIN
coax	k@Uks
cobblestone	kOb@lst@}n
cobweb	`kOb.wEb
cocaine	k@U`kEIn.
cock	kOk
cock-up	`kOk.-ap
cockatoo	kOk@`tu:.
cockpit	`kOk.pIt
cocktail	kOkt{Il
cocky	`kO.ki:
cocoa	`k@U.k@U
coconut	`k@U.k@nat
cod	si:@U`di:.
code	k@Ud
codeine	`k@U.di:n
coerce	k@U`@:s.
coffee	`kO.fi:
coffin	`kO.f@n
cog	kOg
coherent	k@U`hI@.r@nt
cohesion	k@U`hi:.Z@n
coil	ko:Il
coin	ko:In
coincide	k@U@n`sa:Id.
coincidence	k@U`In.s@d@ns
coke	k@Uk
colander	`ka.l@nd@
cold	k@Uld
cold-blooded	`k@Uld.-blad@d
coleslaw	`k@Ul.slo:
colic	`kO.lIk
collaborate	k@`lA.b@rEIt
collapse	k@`lAps.
collar	`kO.l@
collarbone	`kO.l@b@Un
collateral	k@`lA.t@r@l
colleague	`kO.li:g
collect	k@`lEkt.
collective	k@`lEk.tIv
collector	k@`lEk.t@
college	`kO.lIdZ
collide	k@`la:Id.
cologne	k@`l@Un.
colon	`k@U.l@n
colonel	`k@:.n@l
colony	`kO.l@ni:
colossal	k@`lO.s@l
colour	`ka.l@
column	`kO.l@m
coma	`k@U.m@
comb	k@Um
combat	`kOm.bAt
combination	kOmb@`nEI.S@n
combination lock	kOmb@`nEI.S@nlOk
combine	k@m`ba:In.
come	kam
comedy	`kO.m@di:
comet	`kO.m@t
comfort	`kam.f@t
comfortable	`kamf.t@b@l
comic	`kO.mIk
comma	`kO.m@
command	k@`mAnd.
commando	k@`mAn.d@U
commemorate	k@`mE.m@rEIt
commence	k@`mEns.
commend	k@`mEnd.
comment	`kO.mEnt
commentary	`kO.m@ntri:
commerce	`kO.m@:s
commercial	k@`m@:.S@l
commiserate	k@`mI.z@rEIt
commission	k@`mI.S@n
commissioner	k@`mI.S@n@
commit	k@`mIt.
commitment	k@`mIt.m@nt
committee	k@`mI.ti:
commodity	k@`mO.d@ti:
common	`kO.m@n
commonwealth	`kO.m@nwElT
commotion	k@`m@U.S@n
communal	k@`mju:.n@l
commune	`kO.mju:n
communicate	k@`mju:.n@kEIt
communication	k@`mju:.n@kEIS@n
communism	`kO.mj@nIz@m
community	k@`mju:.n@ti:
commute	k@`mju:t.
compact	`kOm.pAkt
compact disc	kOmpAkt`dIsk.
companion	k@m`pA.nj@n
company	`kam.p@ni:
comparative	k@m`pA.r@tIv
compare	k@m`pE@.
comparison	k@m`pA.r@s@n
compartment	k@m`pa:t.m@nt
compass	`kam.p@s
compassion	k@m`pA.S@n
compatible	k@m`pA.t@b@l
compel	k@m`pEl.
compelling	k@m`pE.lIN
compensate	`kOm.p@nsEIt
compere	`kOm.pE@
compete	k@m`pi:t.
competent	`kOm.p@t@nt
competition	kOmp@`tI.S@n
competitive	k@m`pE.t@tIv
compile	k@m`pa:Il.
complacent	k@m`plEI.s@nt
complain	k@m`plEIn.
complaint	k@m`plEInt.
complement	`kOm.pl@m@nt
complete	k@m`pli:t.
complex	`kOm.plEks
complexion	k@m`plEk.S@n
complicated	`kOm.pl@kEIt@d
compliment	`kOm.pl@m@nt
complimentary	kOmpl@`mEn.tri:
comply	k@m`pla:I.
component	k@m`p@U.n@nt
compose	k@m`p@Uz.
compost	`kOm.pOst
compound	`kOm.pa:Und
comprehend	kOmpr@`hEnd.
compress	k@m`prEs.
comprise	k@m`pra:Iz.
compromise	`kOm.pr@ma:Iz
compulsion	k@m`pal.S@n
compulsory	k@m`pal.s@ri:
compute	k@m`pju:t.
computer	k@m`pju:.t@
comrade	`kOm.rEId
con	kOn
concave	`kOn.kEIv
conceal	k@n`si:l.
concede	k@n`si:d.
conceit	k@n`si:t.
conceited	k@n`si:.t@d
conceivable	k@n`si:.v@b@l
conceive	k@n`si:v.
concentrate	`kOn.s@ntrEIt
concept	`kOn.sEpt
conception	k@n`sEp.S@n
concern	k@n`s@:n.
concerning	k@n`s@:.nIN
concert	`kOn.s@t
concession	k@n`sE.S@n
conciliation	k@nsIli:`EI.S@n
concise	k@n`sa:Is.
conclude	k@N`klu:d.
concrete	`kON.kri:t
concur	k@N`k@:.
concurrent	k@N`ka.r@nt
concussion	k@N`ka.S@n
condemn	k@n`dEm.
condensation	kOnd@n`sEI.S@n
condense	k@n`dEns.
condescend	kOnd@`sEnd.
condition	k@n`dI.S@n
conditioned	k@n`dI.S@nd
condom	`kOn.dOm
condone	k@n`d@Un.
conduct	k@n`dakt.
cone	k@Un
confectionery	k@n`fEk.S@nri:
confer	k@n`f@:.
conference	kOnf@r@ns
confess	k@n`fEs.
confide	k@n`fa:Id.
confidence	`kOn.f@d@ns
confident	`kOn.f@d@nt
confidential	kOnf@`dEn.S@l
confine	k@n`fa:In.
confirm	k@n`f@:m.
confiscate	`kOn.f@skEIt
conflict	`kO.nflIkt
conform	k@n`fo:m.
confront	k@n`frant.
confuse	k@n`fju:z.
congested	k@n`dZE.st@d
congratulate	k@n`grA.tS@lEIt
congregate	`kON.gr@gEIt
congregation	kONgr@`gEI.S@n
congress	`kON.grEs
conjunction	k@n`dZaNk.S@n
conjunctivitis	k@ndZaNkt@`va:I.t@s
conjure	`kan.dZ@
connect	k@`nEkt.
conquer	`kON.k@
conscience	`kOn.S@ns
conscientious	kOnSi:`En.S@s
conscious	`kOn.S@s
conscript	`kOn.skrIpt
consecutive	k@n`sE.kj@tIv
consent	k@n`sEnt.
consequence	`kOn.s@kw@ns
conservation	kOns@`vEI.S@n
conservative	k@n`s@:.v@tIv
conserve	k@n`s@:v.
consider	k@n`sI.d@
considerable	k@n`sI.dr@b@l
considerate	k@n`sI.d@r@t
consideration	k@nsId@`rEI.S@n
consist	k@n`sIst.
consistency	k@n`sI.st@nsi:
consistent	k@n`sI.st@nt
consolation	kOns@`lEI.S@n
console	k@n`s@Ul.
consonant	`kOn.s@n@nt
conspicuous	k@n`spI.kju:@s
conspiracy	k@n`spI.r@si:
constable	`kan.st@b@l
constant	`kOn.st@nt
constellation	kOnst@`lEI.S@n
consternation	kOnst@`nEI.S@n
constipation	kOnst@`pEI.S@n
constituency	k@n`stIt.ju:@nsi:
constitution	kOnst@`tju:.S@n
constrict	k@n`strIkt.
construct	k@n`strakt.
constructive	k@n`strak.tIv
consul	`kOn.s@l
consult	k@n`salt.
consultant	k@n`sal.t@nt
consume	k@n`sju:m.
consumer	k@n`sju:.m@
contact	`kOn.tAkt
contagious	k@n`tEI.dZ@s
contain	k@n`tEIn.
container	k@n`tEI.n@
contaminate	k@n`tA.m@nEIt
contemplate	`kOn.t@mplEIt
contemporary	k@n`tEm.p@ri:
contempt	k@n`tEmpt.
contend	k@n`tEnd.
content	`kOn.tEnt
contest	`kOn.tEst
context	`kOn.tEkst
continent	`kOn.t@n@nt
continual	k@n`tI.nju:@l
continue	k@n`tI.nju:
continuous	k@n`tI.nju:@s
contour	`kOn.to:
contraband	`kOn.tr@bAnd
contraception	kOntr@`sEp.S@n
contraceptive	kOntr@`sEp.tIv
contract	`kOn.trAkt
contradict	kOntr@`dIkt.
contrary	`kOn.tr@ri:
contrast	`kOn.tra:st
contribute	k@n`trI.bju:t
control	k@n`tr@Ul.
controversy	`kOn.tr@v@:si:
convalescence	kOnv@`lE.s@ns
convene	k@n`vi:n.
convenience	k@n`vi:.nj@ns
convenient	k@n`vi:.ni:@nt
convent	`kOn.v@nt
convention	k@n`vEn.S@n
conventional	k@n`vEn.S@n@l
conversation	kOnv@`sEI.S@n
converse	`kOn.v@:s
convert	k@n`v@:t.
convertible	k@n`v@:.t@bl
convex	`kOn.vEks
convey	k@n`vEI.
convict	k@n`vIkt.
conviction	k@n`vIk.S@n
convince	k@n`vIns.
convoy	`kOn.vo:I
cook	kUk
cook book	`kUk.bUk
cool	ku:l
coolabah	`ku:.l@ba:
coop	ku:p
cooperate	k@U`O.p@rEIt
coordinate	k@U`o:.d@nEIt
cop	kOp
cope	k@Up
copper	`kO.p@
copy	`kO.pi:
copyright	`kO.pi:%;ra:It
coral	`kO.r@l
cord	ko:d
cordial	`ko:.di:@l
corduroy	`ko:.dZ@ro:I
core	ko:
cork	ko:k
corkscrew	`ko:k.skru:
corn	ko:n
corner	ko:n@
cornflakes	`ko:n.flEIks
corny	`ko:.ni:
coronary	`kO.r@nri:
coronation	kOr@`nEI.S@n
coroner	`kO.r@n@
corporal	`ko:.p@r@l
corporation	ko:p@`rEI.S@n
corps	ko:
corpse	ko:ps
correct	k@`rEkt.
correspond	kOr@`spOnd.
corridor	`kO.r@do:
corroboree	k@`rO.b@ri:
corrode	k@`r@Ud.
corrugated	`kO.r@gEIt@d
corrupt	k@`rapt.
cortisone	`ko:.t@z@Un
cosmetic	kOz`mE.tIk
cosmopolitan	kOzm@`pO.l@tn
cosmos	`kO.zmOs
cossie	`kOzi:
cost	kOst
costume	`kO.stju:m
cosy	`k@U.zi:
cot	kOt
cottage	`kO.tIdZ
cotton	kOt@n
couch	ka:UtS
cough	kOf
could	kUd
council	`ka:Un.s@l
counsel	`ka:Un.s@l
count	ka:Unt
counter	`ka:Un.t@
counterfeit	`ka:Un.t@f@t
country	`kan.tri:
coup	ku:
couple	`ka.p@l
coupon	`ku:.pOn
courage	`ka.rIdZ
courier	`kU.ri:@
course	ko:s
court	ko:t
courteous	`k@:.ti:@s
courtyard	`ko:t.ja:d
cousin	`ka.z@n
cove	k@Uv
covenant	`ka.v@n@nt
cover	`ka.v@
covet	`ka.v@t
cow	ka:U
coward	`ka:U.@d
crab	krAb
crack	krAk
cracker	`krA.k@
crackle	`krA.k@l
crackling	`krA.klIN
cradle	`krEI.d@l
craft	kra:ft
crafty	`kra:f.ti:
crag	krAg
cram	krAm
cramp	krAmp
cramped	krAmpt
crane	krEIn
crank	krANk
cranky	`krAN.ki:
crash	krAS
crate	krEIt
crater	`krEI.t@
crave	krEIv
crawl	kro:l
crayfish	`krEI.fIS
crayon	`krEI.On
craze	krEIz
crazy	`krEI.zi:
creak	kri:k
cream	kri:m
crease	kri:s
create	kri:`EIt.
creature	`kri:.tS@
creche	krEIS
credible	`krE.d@bl
credit	`krE.d@t
creek	kri:k
creep	kri:p
creeper	`kri:.p@
cremate	kr@`mEIt.
crematorium	krEm@`to:.ri:@m
crepe	krEIp
crest	krEst
crevice	`krE.v@s
crew	kru:
crib	krIb
cricket	`krI.k@t
crime	kra:Im
crimson	`krIm.z@n
cringe	krIndZ
crinkle	`krIN.k@l
cripple	`krI.p@l
crisis	`kra:I.s@s
crisp	krIsp
critic	`krI.tIk
critical	`krI.tIk@l
croak	kr@Uk
croatian	kr@U`EI.S@n
crockery	`krO.k@ri:
crocodile	`krO.k@da:Il
crook	krUk
crooked	`krU.k@d
croon	kru:n
crop	krOp
cross	krOs
cross-examine	krOs-Eg`zA.m@n
crossroads	`krOs.r@Udz
crossword	`krOs.w@:d
crouch	kra:UtS
croupier	`kru:.pi:@
crow	kr@U
crowbar	`kr@U.ba:
crowd	kra:Ud
crown	kra:Un
crucial	`kru:.S@l
crucify	`kru:.s@fa:I
crude	kru:d
cruel	`kru:.@l
cruise	kru:z
crumb	kram
crumble	`kram.b@l
crummy	`kra.mi:
crumpet	`kram.p@t
crumple	`kram.p@l
crunch	krantS
crusade	kru:`sEId.
crush	kraS
crust	krast
crustacean	kras`tEI.S@n
crutch	kratS
crux	kraks
cry	kra:I
cryptic	`krIp.tIk
crystal	`krI.st@l
cub	kab
cube	kju:b
cubic	`kju:.bIk
cubicle	`kju:.bIk@l
cucumber	`kju:.kamb@
cuddle	`kad.l
cuddly	`kad.li:
cue	kju:
cuff	kaf
cul-de-sac	`kal.-d@-sAk
culinary	`ka.l@nri:
culminate	`kal.m@nEIt
culprit	`kal.prIt
cult	kalt
cultivate	`kal.t@vEIt
culture	`kal.tS@
cumbersome	`kam.b@s@m
cumquat	`kam.kwOt
cunning	`ka.nIN
cunt	kant
cup	kap
cupboard	`ka.b@d
curb	k@:b
curdle	`k@:d.l
cure	`kju:.@
curious	`kju:.ri:@s
curl	k@:l
currant	`ka.r@nt
currawong	`ka.r@wON
currency	`ka.r@nsi:
current	`ka.r@nt
curriculum	k@`rI.kj@l@m
curriculum vitae	k@rIkj@l@m`vi:.ta:I
curry	`ka.ri:
curse	k@:s
curt	k@:t
curtail	k@:`tEIl.
curtain	`k@:.t@n
curtsy	`k@:t.si:
curve	k@:v
cushion	`kU.S@n
cushy	`kU.Si:
custard	`ka.st@d
custody	`ka.st@di:
custom	`ka.st@m
customary	`ka.st@m@ri:
customer	`ka.st@m@
cut	kat
cute	kju:t
cuticle	`kju:.tIk@l
cutlery	`kat.l@ri:
cutlet	`kat.l@t
cv	si:`vi:
cycle	`sa:I.k@l
cyclone	`sa:I.kl@Un
cylinder	`sI.l@nd@
cynic	`sI.nIk
cynical	`sI.nIkl
cyst	sIst
cystitis	sIs`ta:I.t@s
czech	tSEk
d	di:
dab	dAb
dad	dAd
dagger	`dAg@
daily	`dEIli:
dainty	`dEInti:
dairy	de:r\i:
dais	`dEI@s
dam	dAm
damage	`dAmIdZ
damn	dAm
damned	dAmd
damnedest	`dAmd@st
damp	dAmp
dampen	`dAmp@n
damper	`dAmp@
dance	d{ns
dandruff	`dAndraf
danger	`dEIndZ@
dangle	`dANg@l
dank	dANk
dapper	`dAp@
dappled	`dAp@ld
dare	dE@
daredevil	`dE@dEv@l
dark	da:k
darkroom	`da:kru:m
darling	`da:lIN
darn	da:n
dart	da:t
dash	dAS
dashboard	`dASbo:d
data	`da:t@
database	`dEIt@bEIs
date	dEIt
dated	`dEIt@d
daub	do:b
daughter	`do:t@
daughter-in-law	`do:t@r-In-lo:
daunt	do:nt
dawdle	`do:d@l
dawn	do:n
day	dEI
day care centre	`dEIkE@sEnt@
daybreak	`dEIbrEIk
daydream	`dEIdri:m
daylight	`dEIla:It
daytime	`dEIta:Im
daze	dEIz
dazzle	`dAz@l
de facto	di:`fAkt@U
dead	dEd
dead end	dEd`End
dead heat	dEd`hi:t
dead letter	dEd`lEt@
dead-end	`dE-End
deaden	`dEd@n
deadline	`dEdla:In
deadlock	`dEdlOk
deadly	`dEdli:
deaf	dEf
deal	di:l
dealer	`di:l@
dealings	`di:lINz
dear	dI@
death	dET
debatable	d@`bEIt@b@l
debate	d@`bEIt
debit	`dEb@t
debris	`dEbri:
debt	dEt
debug	di:`bag
debut	`dEI.bju:
decade	`dkEId
decadent	`dEk@d@nt
decaffeinated	di:`kAf@nEIt@d
decapitate	di:`kAp@tEIt
decathlon	d@`kATlOn
decay	di:`kEI
deceased	dE`sIst
deceitful	d@`si:tfUl
deceive	d@`si:v
december	d@`sEmb@
decent	`di:s@nt
decentralise	di:`sEntr@la:Iz
deception	d@`sEpS@n
deceptive	d@`sEptIv
decibel	`dEs@bEl
decide	d@`sa:Id
decided	d@`sa:Id@d
deciduous	d@`sIdZu:@s
decimal	`dEs@m@l
decimate	`dEs@mEIt
decipher	d@`sa:If@
decision	d@`sIZ@n
deck	dEk
declare	d@`klE@
decline	d@`kla:In
decode	di:`k@Ud
decompose	di:k@m`p@Uz
decongestant	di:k@n`dZEst@nt
decor	`dEIko:
decorate	`dEk@rEIt
decoration	dEk@`rEI.S@n
decorum	d@`ko:r@m
decoy	`di:ko:I
decrease	d@`krIs
decree	d@`kri:
decrepit	d@`krEp@t
decry	d@`kra:I
dedicate	`dEd@kEIt
deduce	d@`dju:s
deduct	d@`dakt
deduction	d@`dakS@n
deed	di:d
deep	di:p
deep freeze	di:p`fri:z
deer	dI@
deface	d@`fEIs
defamation	dEf@`mEIS@n
default	d@`fOlt
defeat	d@`fi:t
defecate	`dEf@kEIt
defect	`di:fEkt
defence	d@`fEns
defend	d@`fEnd
defendant	d@`fEnd@nt
defensive	d@`fEnsIv
defer	d@`f@:
defiant	d@`fa:I@nt
deficient	d@`fIS@nt
deficit	`dEf@s@t
define	d@`fa:In
definite	`dEf@n@t
definitive	d@`fIn@tIv
deflate	d@`flEIt
deflation	d@`flEIS@n
deflect	d@`flEkt
defoliant	d@`f@Uli:@nt
defoliate	d@`f@Uli:EIt
deform	d@`fo:m
defraud	d@`fro:d
defrost	di:`frOst
deft	dEft
defunct	d@`faNkt
defuse	di:`fju:z
defy	d@`fa:I
degenerate	d@`dZEn@r@t
degradation	dEgr@`dEIS@n
degrade	d@`grEId
degree	d@`gri:
dehydrate	`di:ha:IdrEIt
deign	dEIn
deity	`dEI@ti:
dejected	d@`dZEkt@d
delay	d@`lEI
delectable	d@`lEkt@b@l
delegate	`dEl@g@t
delegation	dEl@`gEIS@n
delete	d@`li:t
deli	deli:
deliberate	d@`lI.b@r@t
delicacy	`dEl@k@si:
delicate	`dEl@k@t
delicatessen	dEl@k@`tEs@n
delicious	d@`lIS@s
delight	d@`la:It
delinquent	d@`lINkw@nt
delirious	d@`lIri:@s
deliver	d@`lIv@
delta	`dElt@
delude	d@`lu:d
deluge	`dElju:dZ
deluxe	d@`laks
delve	dElv
demand	d@`mAnd
demanding	d@`mAndIN
demean	d@`mi:n
demeanour	d@`mi:n@
demented	d@`mEnt@d
dementia	d@`mEnS@
demerit	di:`mEr@t
demise	d@`ma:Iz
demister	di:`mIst@
demo	`dEm@U
democracy	d@`mOkr@si:
democrat	`dEm.@krAt
democrats	`dEm@krAts
demolish	d@`mOlIS
demon	`di:m@n
demonstrate	`dEm@nstrEIt
demonstration	dEm@n`strEIS@n
demonstrative	d@`mOnstr@tIv
demoralise	d@`mOr@la:Iz
demote	di:`m@Ut
demure	d@`mjU@
den	dEn
denigrate	`dEn@grEIt
denim	`dEn@m
denomination	d@`nOm@nEIS@n
denominator	d@`nOm@nEIt@
denounce	d@`na:Uns
dense	dEns
dent	dEnt
dental	`dEnt@l
dental floss	`dEn.t@lflOs
dentist	`dEnt@st
denture	`dEntS@
deny	d@`na:I
deodorant	di:`@Ud@r@nt
depart	d@`pa:t
departed	d@`pa:t@d
department	d@`pa:tm@nt
depend	d@`pEnd
dependant	d@`pEnd@nt
dependent	d@`pEnd@nt
depict	d@`pIkt
deplete	d@`pli:t
deplore	d@`plo:
deport	d@`po:t
deportment	d@`po:tm@nt
depose	d@`p@Uz
deposit	d@`pOz@t
depository	d@`pOz@tri:
depot	`dEp@U
depraved	d@`prEIvd
depreciate	d@`pri:Si:EIt
depress	d@`prEs
depression	d@`prES@n
deprive	d@`pra:Iv
deprived	d@`pra:Ivd
dept	d@`pa:tm@nt
depth	dEpT
deputation	dEpju:`tEIS@n
deputy	`dEpj@ti:
deranged	d@`rEIndZd
derelict	`dEr@lIkt
deride	d@`ra:Id
derivative	d@`rIv@tIv
derive	d@`ra:Iv
dermatitis	d@:m@`ta:It@s
derogatory	d@`rOg@tri:
descend	d@`sEnd
descendant	d@`sEnd@nt
descended	d@`sEnd@d
descent	d@`sEnt
describe	d@`skra:Ib
description	d@`skrIpS@n
desecrate	`dEs@krEIt
desert	`dEz@t
deserve	d@`z@:v
design	d@`za:In
designate	`dEzIgnEIt
desirable	d@`za:I@r@bl
desire	d@`za:I@
desk	dEsk
desktop	`dEsktOp
desolate	`dEs@l@t
despair	d@`spE@
desperate	`dEspr@t
despicable	d@`spIk@b@l
despise	d@`spa:Iz
despite	d@`spa:It
despondent	d@`spOnd@nt
despot	`dEspOt
dessert	d@`z@:t
destination	dEst@`nEIS@n
destined	`dEst@nd
destiny	`dEst@ni:
destitute	`dEst@tju:t
destroy	d@`stro:I
detach	d@`tAtS
detached	d@`tAtSt
detachment	d@`tAtSm@nt
detail	`di:tEIl
detain	d@`tEIn
detect	d@`tEkt
detective	d@`tEktIv
detention	d@`tEnS@n
deter	d@`t@:
detergent	d@`t@:dZ@nt
deteriorate	d@`tI@ri:@rEIt
determination	d@t@:m@`nEIS@n
determine	d@`t@:m@n
determined	d@`t@:m@nd
determiner	d@`t@:m@n@
deterrent	d@`tEr@nt
detest	d@`tEst
detonate	`dEt@nEIt
detour	`di:tU@
detract	d@`trAkt
detrimental	dEtr@`mEntl
devalue	di:`vAlju:
devastate	`dEv@stEIt
devastating	`dEv@stEItIN
develop	d@`vEl@p
developer	d@`vEl@p@
development	d@`vEl@pm@nt
deviant	`di:vi:@nt
deviate	`di:vi:EIt
device	d@`va:Is
devil	`dEv@l
devious	`di:vi:@s
devise	d@`va:Iz
devoid	d@`vo:Id
devote	d@`v@Ut
devoted	d@`v@Ut@d
devotee	dEv@`ti:
devour	d@`va:U@
devout	d@`va:Ut
dew	dju:
dexterity	dEks`tEr@ti:
diabetes	da:I@`bi:ti:z
diabolic	da:I@`bOlIk
diagnose	`da:I@gn@Uz
diagonal	da:I`Ag@n@l
diagram	`da:I@grAm
dial	`da:I@l
dialect	`da:I@lEkt
dialogue	`da:I@lOg
diameter	da:I`Am@t@
diametrically	da:I@`mEtrIkli:
diamond	`da:I@m@nd
diaphragm	`da:I@frAm
diarrhoea	da:I@`ri:@
diary	`da:I@ri:
dice	da:Is
dicey	`da:Isi:
dick	dIk
dickhead	`dIk.hEd
dictate	dIk`tEIt.
dictator	dIk`tEIt@
diction	`dIkS@n
dictionary	`dIkS@nri:
did	dId
didgeridoo	dIdZ@ri:`du:
die	da:I
diesel	`di:z@l
diet	`da:I@t
differ	`dIf@
difference	`dIfr@ns
different	`dIfr@nt
differentiate	dIf@`rEnSi:EIt
difficult	`dIf@k@lt
diffident	`dIf@d@nt
diffuse	d@`fju:z.
dig	dIg
digest	d@`dZEst
digger	`dIg@
diggings	`dIgINz
digit	`dIdZ@t
digital	`dIdZ@t@l
dignitary	`dIgn@tri:
dignity	`dIgn@ti:
digress	da:I`grEs
dilapidated	d@`lAp@dEIt@d
dilate	da:I`lEIt
dilemma	d@`lEm@
diligent	`dIl@dZ@nt
dill	dIl
dilute	da:I`lu:t
dim	dIm
dimension	d@`mEnS@n
diminish	d@`mInIS
dimple	`dImpl
din	dIn
dine	da:In
diner	`da:In@
ding	dIN
dinghy	`dINgi:
dingo	`dINg@U
dingy	`dIndZi:
dining	`da:InIN
dining car	`da:InINka:
dining room	`da:InINru:m
dining table	`da:InINtEIbl
dinki-di	dINki:-`da:I
dinkum	`dINk@m
dinner	`dIn@
dinosaur	`da:In@so:
dip	dIp
diphtheria	dIf`TI@ri:@
diphthong	`dIfTON
diploma	d@`pl@Um@
diplomacy	d@`pl@Um@si:
diplomat	`dIpl@mAt
dire	da:I@
direct	d@`rEkt
direction	d@`rEkS@n
directive	d@`rEktIv
directly	d@`rEktli:
director	d@`rEkt@
directory	d@`rEktri:
dirt	d@:t
dirty	`d@:ti:
disability	dIs@`bIl@ti:
disable	dIs`EIbl
disadvantage	dIs@d`vAntIdZ
disadvantaged	dIs@d`vAntIdZd
disagree	dIs@`gri:
disagreeable	dIs@`gri:@bl
disallow	dIs@`la:U
disappear	dIs@`pI@
disappoint	dIs@`po:Int
disapprove	dIs@`pru:v
disarm	dIs`a:m
disarray	dIs@`rEI
disaster	dI`za:st@
disband	dIs`bAnd
disbelieve	dIsb@`li:v
disc	dIsk
disc jockey	`dIskdZOki:
discard	dIs`ka:d
discern	dI`s@:n
discerning	dI`s@:nIN
discharge	dIs`tSa:dZ
disciple	d@`sa:Ipl
disciplinarian	dIs@pl@`nE@ri:@n
discipline	`dIs@pl@n
disclose	dIs`kl@Uz
disco	`dIsk@U
discolour	dIs`kal@
discomfort	dIs`kamf@t
disconcert	dIsk@n`s@:t
disconnect	dIsk@`nEkt
discontent	dIsk@n`tEnt
discontinue	dIsk@n`tInju:
discord	`dIsko:d
discount	`dIska:Unt
discourage	dI`skarIdZ
discourse	`dIsko:s
discourteous	dI`sk@:ti:@s
discover	dI`skav@
discredit	dI`skrEd@t
discreet	dI`skri:t
discrepancy	dI`skrEp@nsi:
discrete	dI`skri:t
discretion	dI`skrES@n
discriminate	dI`skrIm@nEIt
discuss	d@s`kas
disdain	dIs`dEIn
disease	d@`zi:z
disfavour	dIs`fEIv@
disfigure	dIs`fIg@
disgrace	d@s`grEIs
disgruntled	dIs`grantld
disguise	dIs`ga:Iz
disgust	d@s`gast
dish	dIS
disheartened	dIs`ha:t@nd
dishevelled	dI`SEv@ld
dishonest	dIs`On@st
dishonour	dIs`On@
dishwasher	`dISwOS@
disillusioned	dIsI`lu:Z@nd
disinclined	dIsIn`kla:Ind
disinfect	dIsIn`fEkt
disinfectant	dIsIn`fEkt@nt
disintegrate	dIs`Int@grEIt
disinterested	dIs`Intr@st@d
disjointed	dIs`dZo:Int@d
disk	dIsk
diskette	dIs`kEt
dislike	dIs`la:Ik
dislocate	`dIsl@kEIt
dislodge	dIs`lOdZ
disloyal	dIs`lo:I@l
dismal	`dIzm@l
dismantle	dIs`mAntl
dismay	dIs`mEI
dismiss	dIs`mIs
dismount	dIs`ma:Unt
disobey	dIs@`bEI
disorder	dIs`o:d@
disorganised	dIs`o:g@na:Izd
disorientated	dIs`Ori:@n;tEIt@d
dispatch	dIs`pAtS
dispel	dI`spEl
dispensable	dI`spEns@bl
dispensation	dIspEn`sEIS@@n
dispense	dI`spEns
disperse	dI`sp@:s
displace	dI`splEIs
display	dI`splEI
displease	dI`spli:z
disposable	dI`sp@Uz@bl
disposable income	dI;sp@Uz@bl`INkam
disposal	dI`sp@Uz@l
dispose	dI`sp@Uz
disposed	dI`sp@Uzd
disposition	dIsp@`zISn
dispossess	dIsp@`zEs
disproportion	dIspr@`po:Sn
disprove	dI`spru:v
dispute	dI`spju:t
disqualify	dI`skwOl@fa:I
disregard	dIsr@`ga:d
disrepair	dIsr@`pE@
disreputable	dIs`rEpj@t@bl
disrepute	dIsr@`pju:t
disrespect	dIsr@`spEkt
disrupt	dIs`rapt
dissatisfied	dI`sAtIsfa:Id
dissect	dI`sEkt
dissension	dI`sEnS@n
dissent	dI`sEnt
dissertation	dIs@`tEIS@n
dissident	`dIs@d@nt
dissimilar	dI`sIm@l@
dissipate	`dIs@pEIt
dissociate	dI`s@Usi:EIt
dissolution	dIs@`lu:S@n
dissolve	d@`zOlv
dissuade	dI`swEId
distance	`dIst@ns
distant	`dIst@nt
distasteful	dI`stEIstfUl
distend	dI`stEnd
distil	dI`stIl
distillate	`dIst@l@t
distinct	d@`stINkt
distinction	d@`stINkS@n
distinctive	d@`stINktIv
distinguish	d@`stINgwIS
distort	d@`sto:t
distract	d@`strAkt
distraught	dI`stro:t.
distress	d@`strEs
distribute	d@`strIbju:t
distribution	dIstr@`bju:S@n
district	`dIstrIkt
distrust	d@`strast
disturb	d@`st@:b
disturbance	d@`st@:b@ns
disturbed	d@`st@:bd
disuse	dIs`ju:s
ditch	dItS
dither	`dID@
ditto	`dIt@U
divan	d@`vAn
dive	da:Iv
diver	`da:Iv@
diverge	da:I`v@:dZ
diverse	da:I`v@:s
diversify	d@`v@:s@fa:I
diversion	d@`v@:Z@n
divide	d@`va:Id
dividend	`dIv@dEnd
divination	dIv@`nEIS@n
divine	d@`va:In
divinity	d@`vIn@ti:
division	d@`vIZ@n
divorce	d@`vo:s
divorcee	d@vo:`si:
divulge	d@`valdZ
dizzy	`dIzi:
do	du:
dob	dOb
docile	`d@Usa:Il
dock	dOk
docket	`dOk@t
dockyard	`dOkja:d
doctor	`dOkt@
doctors	dOkt@z
doctrine	`dOktr@n
document	`dOkj@m@nt
documentary	dOkj@`mEntri:
dodge	dOdZ
dodgy	`dOdZi:
doe	d@U
does	daz
dog	dOg
dog-ear	`dOg-I@
dogged	`dOg@d
dogleg	`dOglEg
dogma	`dOgm@
dogmatic	dOg`mAtIk
doily	`do:Ili:
doing	`du:IN
doldrums	`dOldr@mz
dole	d@Ul
doleful	`d@UlfUl
doll	dOl
dollar	`dOl@
dollop	`dOl@p
doll’s	dOlz
domain	d@`mEIn
dome	d@Um
domestic	d@`mEstIk
domesticate	d@`mEstIkEIt
dominate	`dOm@nEIt
domineering	dOm@`nI@rIN
donate	d@U`nEIt
done	dan
donkey	`dONki:
donor	`d@Un@
dont	d@Unt
doodle	`du:dl
doom	du:m
doomsday	`du:mzdEI
doona	`du:n@
door	do:
dope	d@Up
dopey	`d@Upi:
dork	do:k
dorm	do:m
dormant	`do:m@nt
dormitory	`do:m@tri:
dose	d@Us
dossier	`dOsi:@
dot	dOt
dote	d@Ut
dotty	`dOti:
double	`dabl
double bass	dabl`bEIs
doublecross	dabl`krOs
doubt	da:Ut
doubtful	`da:UtfUl
dough	d@U
dour	dU@
douse	da:Us
dove	dav
dowdy	`da:Udi:
down	d{On
down payment	da:Un`pEIm@nt
down-market	da:Un-`ma:k@t
down-to-earth	da:Un-tu:-`@:T
downcast	`da:Unka:st
downfall	`da:Unfo:l
downgrade	da:Un`grEId
downhearted	da:Un`ha:t@d
downhill	da:Un`hIl
downplay	da:Un`plEI
downpour	`da:Unpo:
downstream	da:Un`stri:m
downtown	d{Ont{On
downtrodden	da:Un`trOdn
downturn	`da:Unt@:n
downward	`da:Unw@d
downwards	`da:Unw@dz
downwind	da:Un`wInd
downy	`da:Uni:
dowry	`da:Uri:
doz.	`daz@n
doze	d@Uz
dozen	`daz@n
dr	`dOkt@
drab	drAb
draft	dra:ft
drag	drAg
dragon	`drAg@n
dragonfly	`drAg@nfla:I
drain	drEIn
drake	drEIk
drama	`dra:m@
dramatic	dr@`mAtIk
dramatise	`drAm@ta:Iz
drank	drANk
drape	drEIp
drastic	`drAstIk
draught	dra:ft
draw	dro:
drawback	`dro:bAk
drawcard	`dro:ka:d
drawer	dro:
drawing-pin	`dro:IN-pIn
drawl	dro:l
drawn	dro:n
dread	drEd
dreadful	`drEdfUl
dream	dri:m
dreaming	`dri:mIN
dreamt	drEmt
dreary	`drI@ri:
drench	drEntS
dress	drEs
dresser	`drEs@
dressing	`drEsIN
dressing-gown	`drEsIN-ga:Un
dressing-table	`drEsIN-tEIb@l
dressmaker	`drEsmEIk@
drew	dru:
dribble	`drIb@l
dried	dra:Id
drier	`dra:I@
drift	drIft
drill	drIl
drink	drINk
drink-driving	drINk-`dra:IvIN
drip	drIp
drip-dry	`drIp-dra:I
dripping	`drIpIN
drive	dr\Aev
drive-in	`dra:Iv-In
drivers licence	`dra:Iv@zla:Is@ns
driveway	`dra:IvwEI
driving test	`dra:IvINtEst
drizzle	`drIz@l
drone	dr@Un
drongo	`drO.Ng@U
droop	dru:p
drop	drOp
drop-out	`drOp-a:Ut
droplet	`drOpl@t
dropper	`drOp@
droppings	`drOpINz
drought	dra:Ut
drove	dr@Uv
drown	dra:Un
drowsy	`dra:Uzi:
drug	dr\6g
drum	dram
drumstick	`dramstIk
drunk	draNk
dry	dra:I
dry-clean	dra:I-`kli:n
dual	`dju:@l
dub	dab
dubious	`dju:bi:@s
duck	dak
due	dju:
duel	`dju:@l
duet	dju:`Et
dug	dag
dugout	`daga:Ut
dull	dal
duly	`dju:li:
dumb	dam
dummy	`dami:
dump	damp
dumpling	`damplIN
dumpy	`dampi:
dune	dju:n
dung	daN
dunk	daNk
dunny	`dani:
duo	`dju:@U
duodenum	dju:@`di:n@m
dupe	dju:p
duplex	`dju:plEks
duplicate	`dju:pl@kEIt
durable	`dju:r@b@l
duration	dju:`rEIS@n
during	`dju:rIN
dusk	dask
dust	dast
dustpan	`dastpAn
dutch	datS
duty	`dju:ti:
duty-free	dju:ti:-`fri:
duvet	`du:vEI
dwarf	dwo:f
dwell	dwEl
dwindle	`dwIndl
dye	da:I
dying	`da:IN
dynamic	da:I`nAmIk
dynamics	da:I`nAmIks
dynamite	`da:In@ma:It
dysentery	`dIs@ntri:
dyslexia	dIs`lEksi:@
e	i:
e-mail	`i:-mEIl
e.g.	i:`dZi:
each	i:tS
eager	`i:g@
ear	I@
eardrum	`I@dram
early	`@:li:
earn	@:n
earnest	`@:n@st
earphone	`I@f@Un
earring	`rI@rIN
earth	@:T
earthenware	`@:D@nwE@
earthquake	`@:TkwEIk
ease	i:z
easel	`i:z@l
east	i:st
easter	`i:st@
eastward	`i:stw@d
easy	`i:zi:
eat	i:t
eaves	i:vz
eavesdrop	`i:vzdrOp
eb	i:`bi:.
ebb	Eb
eccentric	Ek`sEntrIk
ecg	i:si:`dZi:
echidna	@`kIdn@
echo	`Ek@U
eclipse	@`klIps
ecology	@`kOl@dZi:
economics	Ek@`nOmIks
economy	@`kOn@mi:
eczema	`Eks@m@
edge	EdZ
edible	`Ed@b@l
edit	`Ed@t
edition	@`dIS@n
editorial	Ed@`to:ri:@l
education	EdZ@`kEIS@n
eerie	`I@ri:
effect	@`fEkt
effective	@`fEktIv
effeminate	@`fEm@n@t
effervescent	Ef@`vEs@nt
efficient	@`fISnt
effort	`Ef@t
eftpos	`EftpOs
egg	Eg
ego	`i:g@U
eiderdown	`a:Id@da:Un
eight	EIt
eighteen	EI`ti:n
eighteenth	EI`ti:nT
eighth	EItT
eighty	`EIti:
either	`a:ID@
eject	@`dZEkt
elaborate	@`lAb.@r@t
elapse	@`lAps
elastic	@`lAstIk
elated	@`lEIt@d
elbow	`Elb@U
elder	`Eld@
elderly	`Eld@li:
eldest	`Eld@st
elect	@`lEkt
election	@`lEkS@n
elective	@`lEktIv
electorate	@`lEkt@r@t
electrician	@lEk`trIS@n
electricity	@lEk`trIs@ti:
electrocute	@`lEktr@kju:t
electronic	El@k`trOnIk
elegant	`El@g@nt
element	`El@m@nt
elementary	El@`mEntri:
elevate	`El@vEIt
elevator	`El@vEIt@
eleven	@`lEv@n
eleventh	@`lEv@nT
eligible	`El@dZ@b@l
eliminate	@`lIm@nEIt
elite	@`li:t
ellipse	@`lIps
eloquent	`El@kw@nt
else	Els
elsewhere	`ElswE@
elusive	@`lu:sIv
embargo	Em`ba:g@U
embark	Em`ba:k
embarrass	Em`bAr@s
embassy	`Emb@si:
embezzle	Em`bEz@l
emblem	`Embl@m
embrace	Em`brEIs
embroider	Em`bro:Ud@
embryo	`Embri:@U
emerald	`Emr@ld
emerge	@`m@:dZ
emergency	@`m@:dZ@nsi:
emigrant	`Em@gr@nt
emigrate	`Em@grEIt
eminent	`Em@n@nt
emotion	@`m@US@n
emphasis	`Emf@s@s
empire	`Empa:I@
employ	Em`plo:I
empty	`Emti:
emu	`i:mju:
enable	En`EIb@l
enamel	@`nAm@l
enclose	En`kl@Uz
encode	En`k@Ud
encore	`Onko:
encounter	En`ka:Unt@
encourage	En`karIdZ
encyclopedia	Ensa:Ikl@`pi:di:@
end	end
endanger	En`dEIndZ@
endeavour	En`dEv@
endorse	En`do:s
endure	En`djU@
enemy	`En@mi:
energy	`En@dZi:
engage	En`gEIdZ
engagement	En`gEIdZm@nt
engine	`EndZ@n
engineer	EndZ@`nI@
english	`INglIS
engrave	En`grEIv
enjoy	En`dZo:I
enlarge	En`la:dZ
enlist	En`lIst
enormous	@`no:m@s
enough	@`naf
enquiry	In`kwa:Iri:
enrage	En`rEIdZ
enrich	En`rItS
enrol	En`r@Ul
ensuite	`Onswi:t
ensure	En`So:
entangled	En`tANg@ld
enter	`Ent@
enterprise	`Ent@pra:Iz
enterprise bargaining	Ent@pra:Iz`ba:g@nIN
entertain	Ent@`tEIn
enthusiasm	En`Tu:zi:Az@m
entice	En`ta:Is
entire	En`ta:I@
entitle	En`ta:Itl
entrance	`Entr@ns
entrant	`Entr@nt
entreat	En`tri:t
entree	`OntrEI
entrepreneur	Ontr@pr@`n@:
entry	`Entri:
envelope	`Env@l@Up
environment	En`va:Ir@nm@nt
envy	`Envi:
epic	`EpIk
epidemic	Ep@`dEmIk
epilepsy	`Ep@lEpsi:
episode	`Ep@s@Ud
epitome	@`pIt@mi:
epoch	`i:pOk
equal	`i:kw@l
equator	@`kwEIt@
equip	@`kwIp
equipment	@`kwIpm@nt
equivalent	@`kwIv@l@nt
era	`I@r@
eradicate	@`rAd@kEIt
erase	@`rEIz
erect	@`rEkt
erode	@`r@Ud
erotic	@`rOtIk
err	@:
errand	`Er@nd
erratic	@`rAtIk
error	`Er@
erupt	@`rapt
escalate	`Esk@lEIt
escalator	`Esk@lEIt@
escapade	`Esk@pEId
escape	@s`kEIp
escort	@s`ko:t
esky	`Es.ki:
esl	i:Es`El
especially	@s`pES@li:
espionage	`Espi:@na:Z
essay	`EsEI
essence	`Es@ns
essential	@`sEnS@l
establish	@s`tAblIS
establishment	@s`tAblISm@nt
estate	@st{It
estate agent	@`stEItEIdZ@nt
esteem	@s`ti:m
estimate	`E.st@mEIt
estranged	@`strEIndZd
etc.	Et`sEtr@
etch	EtS
etching	`EtSIN
eternal	@`t@:n@l
ethics	`ETIks
ethnic	`ETnIk
etiquette	`EtIk@t
eucalyptus	ju:k@`lIpt@s
euthanasia	ju:T@`nEIZ@
evacuate	@`vAkju:EIt
evade	@`vEId
evaluate	@`vAlju:EIt
evaporate	@`vAp@rEIt
eve	i:v
even	`i:v@n
evening	`i:vnIN
evening class	`i:vnINkla:s
evening dress	`i:vnINdrEs
event	@`vEnt
eventually	@`vEntS@li:
ever	`Ev@
evergreen	`Ev@gri:n
every	`Evri:
everybody	`Evri:bOdi:
everyday	`Evri:dEI
everyone	`Evri:wan
everything	`Evri:TIN
everywhere	`Evri:wE@
evict	@`vIkt
evidence	`Ev@d@ns
evident	`Ev@d@nt
evil	`i:v@l
evolution	Ev@`lu:S@n
ex-	Eks-
exact	@g`zAkt
exactly	@g`zAktli:
exaggerate	@g`zAdZ@rEIt
exam	@g`zAm
examination	@gzAm@`nEIS@n
examine	@g`zAm@n
example	@g`zAmp@l
exasperate	@g`zAsp@rEIt
excavate	`Eksk@vEIt
exceed	@k`si:d
excel	@k`sEl
excellent	`Eks@l@nt
except	@k`sEpt
exception	@k`sEpS@n
exceptional	@k`sEpS@n@l
excess	`EksEs
exchange	@ks`tSEIndZ
excite	@k`sa:It
excited	@k`sa:It@d
exciting	@k`sa:ItIN
exclaim	@ks`klEIm
exclamation	Ekskl@`mEIS@n
exclude	@ks`klu:d
exclusive	@ks`klu:sIv
excrete	@ks`kri:t
excruciating	@ks`kru:Si:EItIN
excursion	@k`sk@:S@n
excuse	@k`skju:s
execute	`Eks@kju:t
executive	@g`zEkj@tIv
executor	@g`sEkju:t@
exempt	@g`zEmpt
exercise	`Eks@sa:Iz
exert	@g`z@:t
exhale	Eks`hEIl
exhaust	@g`zo:st
exhaustive	@g`zo:stIv
exhibit	@g`zIb@t
exile	`Egza:Il
exist	@g`zIst
exit	`Egz@t
exodus	`Eks@d@s
exotic	@g`zOtIk
expand	@k`spAnd
expanse	@k`spAns
expect	@k`spEkt
expedition	Eksp@`dIS@n
expel	@k`spEl
expend	@k`spEnd
expenditure	Ek`spEnd@tS@
expense	@k`spEns
expensive	@k`spEnsIv
experience	@k`spI@ri:Ens
experiment	@k`spEr@m@nt
expert	`Eksp@:t
expire	@k`spa:I@
explain	@k`splEIn
expletive	@k`spli:tIv
explode	@k`spl@Ud
exploit	@k`splo:It.
explore	@k`splo:
explosion	@k`spl@UZ@n
explosive	Ek`spl@UsIv
export	@k`spo:t
expose	@k`sp@Uz
exposure	@k`sp@UZ@
express	@k`sprEs
expression	@k`sprES@n
expressway	Ek`sprEswEI
expulsion	@k`spalS@n
exquisite	`Ekskw@z@t
extend	@k`stEnd
extension	@k`stEnS@n
extensive	@k`stEnsIv
extent	@k`stEnt
exterior	@k`stI@ri:@
exterminate	@k`st@:m@nEIt
external	@k`st@:n@l
extinct	@k`stINkt
extinguish	@k`stINgwIS
extortion	@k`sto:S@n
extra	`Ekstr@
extract	@k`strAkt.
extraordinary	@k`stro:d@nri:
extravagant	@k`strAv@g@nt
extreme	@k`stri:m
extremism	@k`stri:mIz@m
eye	a:I
eyebrow	`a:Ibra:U
eyelash	`a:IlAS
eyelid	`a:IlId
eyesight	`a:Isa:It
eyesore	`a:Iso:
eyewitness	`a:IwItn@s
f	Ef
fable	`fEI.b@l
fabric	`fAbrIk
fabricate	`fAbr@kEIt
fabulous	`fAbju:l@s
facade	f@`sa:d
face	fEIs
faceless	`fEIsl@s
facelift	`fEIslIft
facet	`fAs@t
facilitate	f@`sIl@tEIt
facility	f@`sIl@ti:
facsimile	fAk`sIm@li:
fact	fAkt
faction	`fAkS@n
factor	`fAkt@
factory	f{ktr\i:
factual	`fAktSu:@l
faculty	`fAk@lti:
fad	fAd
fade	fEId
faeces	`fi:si:z
fag	fAg
fahrenheit	`fAr@nha:It
fail	fEIl
failing	`fEIlIN
failure	`fEIlj@
faint	fEInt
fair	fE@
fairly	`fE@li:
fairway	`fE@wEI
fairy	`fE@ri:
fairy bread	`fE@ri:brEd
fairy floss	`fE@ri:flOs
fairytale	`fE@ri:tEIl
faith	fEIT
faithful	`fEITf@l
fake	fEIk
fall	fo:l
fallacy	`fAl@si:
fallible	`fAl@b@l
fallout	`fo:la:Ut
false	fOls
falter	`fo:lt@
fame	fEIm
familiar	f@`mIlj@
family	`fAm@li:
family allowance	fAmli:@`la:U@ns
family law	fAmli:`lo:
family planning	fAmli:`plAnIN
family room	fAmli:`ru:m
famine	`fAm@n
famished	`fAmISt
famous	`fEIm@s
fan	fAn
fanatic	f@`nAtIk
fanbelt	`fAnbElt
fanciful	`fAns@f@l
fancy	`fAnsi:
fang	fAN
fantastic	fAn`tAstIk
fantasy	`fAnt@si:
far	fa:
far-fetched	fa:-`fEtSt
far-reaching	fa:-`ri:tSIN
far-sighted	fa:-`sa:It@d
farce	fa:s
fare	fE@
farewell	fE@`wEl
farm	fa:m
fart	fa:t
farther	`fa:D@
fascinate	`fAs@nEIt
fashion	f{S@n
fast	fa:st
fast food	fa:st`fu:d
fasten	`fa:s@n
fat	fAt
fat cat	`fAtkAt
fatal	`fEIt@l
fatalistic	fEIt@`lIstIk
fatality	f@`tAl@ti:
fate	fEIt
father	`fa:D@
father-in-law	`fa:D@r-In-lo:
fatigue	f@`ti:g
fatso	`fAts@U
fault	fOlt
fauna	`fo:n@
favour	`fEIv@
favourable	`fEIv@r@b@l
favourite	`fEIv@r@t
fax	fAks
faze	fEIz
fear	fI@
fearful	`fI@f@l
feasible	`fi:z@b@l
feast	fi:st
feat	fi:t
feather	`fED@
feature	`fi:tS@
february	`fEbru:@ri:
fed	fEd
federal	`fEd@r@l
federate	`fEd@rEIt
fee	fi:
feeble	`fi:b@l
feed	fi:d
feedback	`fi:dbAk
feel	fi:l
feeler	`fi:l@
feeling	`fi:lIN
feet	fi:t
feign	fEIn
fell	fEl
fellow	`fEl@U
felony	`fEl@ni:
felt	fElt
female	`fi:mEIl
feminine	`fEm@n@n
feminist	`fEm@n@st
fence	fens
fencing	`fEn.sIN
fend	fEnd
feral	`fEr@l
ferment	f@`mEnt.
ferocious	f@`r@US@s
ferris wheel	`fEr@swi:l
ferry	`fEri:
fertile	`f@:ta:Il
fertilisation	f@:t@la:I`zEIS@n
fertiliser	`f@:t@la:Iz@
fervent	`f@:v@nt
fester	`fEst@
festival	`fEst@v@l
festive	`fEstIv
festoon	fEs`tu:n
fetch	fEtS
fete	fEIt
fetid	`fEt@d
fetus	`fi:t@s
feud	fju:d
fever	`fi:v@
few	fju:
fiance	fi:`OnsEI
fiancee	fi:`OnsEI
fiasco	fi:`Ask@U
fib	fIb
fibre	`fa:Ib@
fibreglass	`fa:Ib@gla:s
fibro	`fa:Ibr@U
fiction	`fIkS@n
fiddle	`fIdl
fiddly	`fIdli:
fidelity	f@`dEl@ti:
fidget	`fIdZ@t
field	fI@ld
fierce	fI@s
fiery	`fa:I@ri:
fifteen	fIf`ti:n
fifteenth	fIf`ti:nT
fifth	fIfT
fifty	`fIfti:
fight	fa:It
figment	`fIgm@nt
figure	`fIg@
file	fa:Il
filial	`fi:li:@l
filing	`fa:IlIN
filipino	fIl@`pi:n@U
fill	fIl
fillet	`fIl@t
filling	`fIlIN
film	fIlm
filter	`fIlt@
filthy	`fIlTi:
fin	fIn
final	`fa:In@l
finale	f@`na:li:
finalise	`fa:In@la:Iz
finalist	`fa:In@l@st
finally	`fa:In@li:
finance	`fa:InAns
financial	f@`nAnS@l
find	fa:Ind
fine	fa:In
finger	`fINg@
fingernail	`fINg@nEIl
fingerprint	`fINg@prInt
finicky	`fInIki:
finish	fInIS
finite	`fa:Ina:It
fire	fAe@
firearm	`fa:I@ra:m
firebreak	`fa:I@brEIk
firefighter	`fa:I@fa:It@
fireplace	`fa:I@plEIs
fireproof	`fa:I@pru:f
firewood	`fa:I@wUd
fireworks	`fa:I@w@:ks
firm	f@:m
first	f@:st
first-class	`f@:st-kla:s
first-hand	`f@:sthAnd
fish	fIS
fisherman	`fIS@m@n
fishy	`fISi:
fist	fIst
fit	fIt
fitness	`fItn@s
fitting	`fItIN
five	fa:Iv
fix	fIks
fixture	`fIkstS@
fizz	fIz
fizzer	`fIz@
fizzle	`fIz@l
flab	flAb
flabbergasted	`flAb@ga:st@d
flaccid	`flAs@d
flag	fl{g
flagon	`flAg@n
flagrant	`flEIgr@nt
flair	flE@
flak	flAk
flake	flEIk
flamboyant	flAm`bo:I@nt
flame	flEIm
flaming	`flEImIN
flammable	`flAm@b@l
flan	flAn
flank	flANk
flannel	`flAn@l
flannelette	flAn@`lEt
flap	flAp
flapjack	`flApdZAk
flare	flE@
flash	flAS
flash flood	flAS`flad
flashback	`flASbAk
flashlight	`flASla:It
flashy	`flASi:
flask	fla:sk
flat	flAt
flatette	flAt`Et
flatten	`flAt@n
flatter	`flAt@
flatulence	`flAtS@l@ns
flaunt	flo:nt
flautist	`flo:t@st
flavour	`flEIv@
flaw	flo:
flax	flAks
flea	fli:
flea market	`fli:ma:k@t
flea-bitten	`fli:-bItn
fled	flEd
fledgling	`flEdZlIN
flee	fli:
fleece	fli:s
fleet	fli:t
fleeting	`fli:tIN
flesh	flES
flew	flu:
flex	flEks
flexible	`flEks@b@l
flexitime	`flEksi:ta:Im
flick	flIk
flicker	`flIk@
flight	fla:It
flimsy	`flImzi:
flinch	flIntS
fling	flIN
flint	flInt
flip	flIp
flippant	`flIp@nt
flipper	`flIp@
flirt	fl@:t
flit	flIt
float	fl@Ut
flock	flOk
flog	flOg
flood	flad
floodlight	`fladla:It
floor	flo:
floorboard	`flo:bo:d
flop	flOp
floppy	`flOpi:
flora	`flo:r@
floral	`flOr@l
florist	`flOr@st
floss	flOs
flour	`fla:U@
flourish	`flarIS
flout	fla:Ut
flow	fl@U
flower	`fla:U@
flowerbed	`fla:U@bEd
flowery	`fla:U@ri:
flown	fl@Un
flu	flu:
fluctuate	`flaktSu:EIt
flue	flu:
fluent	`flu:@nt
fluff	flaf
fluid	`flu:@d
fluke	flu:k
flunk	flaNk
fluorescent	flU@`rEs@nt
fluoride	`flU@ra:Id
flurry	`flari:
flush	flaS
fluster	`flast@
flute	flu:t
flutter	`flat@
fly	fla:I
flying saucer	fla:IIN`so:.s@
foal	f@Ul
foam	f@Um
fob	fOb
focus	`f@U.k@s
fodder	`fOd@
foetus	`fi:.t@s
fog	fOg
foil	fo:Il
fold	f@Uld
folder	`f@U.ld@
foliage	`f@Uli:IdZ
folk	f@Uk
folklore	`f@Uk.lo:
follow	`fOl@U
follow-up	`fOl@U-ap
follower	`fOl@U@
following	`fOl@UIN
folly	`fOli:
fond	fOnd
food	fu:d
foodstuff	`fu:dstaf
fool	fu:l
foolproof	`fu:lpru:f
foot	fUt
football	fUtbo:l
footing	`fUtIN
footnote	`fUtn@Ut
footpath	`fUtpa:T
footprint	`fUtprInt
footstep	`fUtstEp
footwear	`fUtwE@
for	fo:
forage	`fOrIdZ
forbearance	fo:`bE@r@ns
forbid	f@`bId
forbidding	f@`bIdIN
force	fo:s
forceful	`fo:sfUl
forceps	`fo:s@ps
forcible	`fo:s@b@l
ford	fo:d
fore	fo:
forearm	`fo:ra:m
forebear	`fo:bE@
forecast	`fo:ka:st
forefinger	`fo:fINg@
foreground	`fo:gra:Und
forehead	`fOr@d
foreign	`fOr@n
foreman	`fo:m@n
foremost	`fo:m@Ust
forensic	f@`rEnsIk
foresee	fo:`si:
foreshadow	fo:`SAd@U
forest	`fOr@st
forestry	`fOr@stri:
forever	f@r`Ev@
foreword	`fo:w@:d
forfeit	`fo:f@t
forge	fo:dZ
forget	f@`gEt
forgive	f@`gIv
fork	fo:k
forklift	`fo:klIft
forlorn	f@`lo:n
form	fo:m
formal	`fo:m@l
format	`fo:mAt
formation	fo:`mEIS@n
former	`fo:m@
formidable	`fo:m@d@b@l
formula	`fo:mj@l@
formulate	`fo:mj@lEIt
forsake	f@`sEIk
fort	fo:t
forte	`fo:tEI
forth	fo:T
forthcoming	fo:T`kamIN
forthright	`fo:Tra:It
fortify	`fo:t@fa:I
fortnight	`fo:tna:It
fortress	`fo:tr@s
fortunate	`fo:tS@n@t
fortune	`fo:tS@n
forty	`fo:ti:
forum	`fo:r@m
forward	`fo:w@d
fossick	`fOsIk
fossil	`fOs@l
foster	`fOst@
fought	fo:t
foul	fa:Ul
foul-mouthed	`fa:Ul-ma:UDd
found	fa:Und
foundation	fa:Un`dEIS@n
fountain	`fa:Unt@n
fountain pen	`fa:UntnpEn
four	fo:
four-letter word	fo:-lEt@`w@:d
four-wheel drive	fo:-wi:l`dra:Iv
fourteen	`fo:ti:n
fourteenth	fo:`ti:nT
fourth	fo:T
fox	fOks
foyer	`fo:I@
fraction	`frAkS@n
fracture	`frAk.tS@
fragile	`frAdZa:Il
fragment	`frAgm@nt
fragrance	`frEIgr@ns
frail	frEIl
frame	frEIm
framework	`frEImw@:k
franchise	`frAntSa:Iz
frank	frANk
frankfurt	`frANkf@t
frantic	`frAntIk
fraternal	fr@`t@:nl
fraud	fro:d
fraught	fro:t
fray	frEI
frazzled	`frAz@ld
freak	fri:k
freckle	`frEk@l
free	fri:
free-for-all	`fri:-f@r-o:l
free-range	`fri:-rEIndZ
freebie	`fri:bi:
freedom	`fri:d@m
freehand	`fri:hAnd
freehold	`fri:h@Uld
freelance	`fri:lAns
freeloader	`fri:l@Ud@
freestyle	`fri:sta:Il
freeway	`frIwEI
freeze	fri:z
freeze-dry	`fri:z-dra:I
freezer	`fri:z@
freight	frEIt
french	frEntS
frenetic	fr@`nEtIk
frenzy	`frEnzi:
frequency	`fri:kw@nsi:
frequent	`fri:kw@nt
fresh	frES
freshwater	`frESwo:t@
fret	frEt
friction	`frIkS@n
friday	`fra:IdEI
fridge	frIdZ
fried	fra:Id
friend	frEnd
friendly	`frEndli:
friendship	`frEndSIp
fright	fra:It
frighten	`fra:It@n
frightful	`fra:ItfUl
frill	frIl
fringe	frIndZ
frisk	frIsk
fritter	`frIt@
frivolous	`frIv@l@s
frizzy	`frIzi:
frock	frOk
frog	frOg
frogman	`frOgm@n
frolic	`frOlIk
from	frOm
front	frant
frontier	fran`tI@
frost	frOst
frostbite	`frOstba:It
froth	frOT
frown	fra:Un
froze	fr@Uz
frozen	`fr@Uz@n
frugal	`fru:g@l
fruit	fru:t
fruitcake	`fru:tkEIk
frustrate	fras`trEIt
fry	fra:I
fuck	fak
fuckwit	`fakwIt
fudge	fadZ
fuel	`fju:@l
fugitive	`fju:dZ@tIv
fulfil	fUl`fIl
full	fUl
full stop	fUl`stOp
full-time	fUl-`ta:Im
fully-fledged	`fUli:-flEdZd
fumble	`fambl
fume	fju:m
fumigate	`fju:m@gEIt
fun	fan
function	`faNkS@n
functional	`faNkS@n@l
fund	fand
fundamental	fand@`mEntl
funeral	`fju:nr@l
fungus	`faNg@s
funnel	`fanl
funnel-web	`fan@lwEb
funny	`fani:
fur	f@:
furious	`fju:ri:@s
furnace	`f@:n@s
furnish	`f@:nIS
furniture	`f@:nItS@
furore	`fju:ro:
furrow	`far@U
further	`f@:D@
furthest	`f@:D@st
furtive	`f@:tIv
fury	`fju:ri:
fuse	fju:z
fuss	fas
fussy	`fasi:
futile	`fju:ta:Il
future	`fju:tS@
future tense	fju:tS@`tEns
fuzz	faz
fuzzy	`fazi:
g	dZi:
gable	`gEIb@l
gadget	`gAdZ@t
gag	gAg
gaggle	`gAg@l
gaiety	`gEI@ti:
gain	gEIn
gait	gEIt
gala	`ga:l@
galah	g@`la:
galaxy	`gAl@ksi:
gale	gEIl
gall bladder	`go:lblAd@
gallery	`gAl@ri:
gallon	`gAl@n
gallop	`gAl@p
gallstone	`go:lst@Un
gallup poll	`gAl@pp@Ul
galore	g@`lo:
galvanise	`gAlv@na:Iz
gamble	`gAmb@l
game	gEIm
gaming	`gEI.mIN
gang	gAN
gangrene	`gANgri:n
gangster	`gANst@
gaol	dZEIl
gap	gAp
gape	gEIp
garage	`gAra:Z
garbage	`ga:bIdZ
garden	`ga:dn
gardener	`ga:dn@
gargle	`ga:g@l
garish	`gE@rIS
garlic	`ga:lIk
garment	`ga:m@nt
garnish	`ga:nIS
garret	`gAr@t
gas	gAs
gash	gAS
gasket	`gAsk@t
gasp	gAsp
gastric	`gAstrIk
gate	gEIt
gatecrash	`gEItkrAS
gather	`gAD@
gaudy	`go:di:
gauge	gEIdZ
gaunt	go:nt
gauze	go:z
gave	gEIv
gawk	go:k
gawky	`go:ki:
gay	gEI
gaze	gEIz
gazump	g@`zamp
gdp	dZi:di:`pi:
gear	gI@
gel	dZEl
gelatine	`dZEl@ti:n
gem	dZEm
gender	`dZEnd@
gene	dZi:n
general	`dZEnr@l
generate	`dZEn@rEIt
generation	dZEn@`rEIS@n
generic	dg@`nErIk
generous	`dZEn@r@s
genesis	`dZEn@s@s
genetics	dZ@`nEtIks
genial	`dZi:ni:@l
genitals	`dZEn@tlz
genius	`dZi:ni:@s
genocide	`dZEn@sa:Id
genre	`ZOnr@
gentile	`dZEnta:Il
gentle	`dZEntl
gentleman	`dZEntlm@n
genuine	`dZEnju:@n
geography	dZi:`Ogr@fi:
geology	dZi:`Ol@dZi:
geometry	dZi:`Om@tri:
geriatric	dZEri:`AtrIk
geriatrics	dZEri:`AtrIks
germ	dZ@:m
german	`dZ@:m@n
gerrymander	`dZEri:mAnd@
gesticulate	dZEs`tIkj@lEIt
gesture	`dZEstS@
get	gEt
ghastly	`ga:stli:
gherkin	`g@:k@n
ghetto	`gEt@U
ghost	g@Ust
giant	`dZa:I@nt
gibber	`dZIb@
gibberish	`dZIb@rIS
giddy	`gIdi:
gift	gIft
gigantic	dZa:I`gAntIk
giggle	`gIg@l
gild	gIld
gilt	gIlt
gimmick	`gImIk
ginger	`dZIndZ@
gingerly	`dZIndZ@li:
gingham	`gIN@m
gipsy	`dZIpsi:
girl	g@:l
girlfriend	`g@:l.frEnd
girls’	g3:lz
girth	g@:T
gist	dZIst
give	gIv
given name	`gIv@nnEIm
glacier	`glEIsi:@
glad	glAd
glamour	`glAm@
glance	glAns
gland	glAnd
glare	glE@
glaring	`glE@rIN
glass	gla:s
gleam	gli:m
glean	gli:n
glee	gli:
glib	glIb
glide	gla:Id
glimmer	`glIm@
glimpse	glImps
glint	glInt
glisten	`glIs@n
glitter	`glIt@
gloat	gl@Ut
globe	gl@Ub
gloomy	`glu:mi:
glorious	`glo:ri:@s
glory	`glo:ri:
gloss	glOs
glossary	`glOs@ri:
glove	glav
glow	gl@U
glucose	`glu:k@Us
glue	glu:
glum	glam
glut	glat
glutton	`glat@n
gnash	nAS
gnaw	no:
gnp	dZi:En`pi:
go	g@}
goal	g@Ul
goalkeeper	`g@Ulki:p@
goat	g@Ut
gobble	`gOb@l
god	gOd
goggle	`gOg@l
gold	g@Uld
golden	`g@U.ld@n
golden syrup	g@Uld@n`sIr@p
goldmine	`g@Uldma:In
golf	gOlf
gone	gOn
gonorrhoea	gOn@`ri:.@
good	gUd
goodbye	gUd`ba:I
goodness	`gUdn@s
goods	gUdz
goose	gu:s
gorge	go:dZ
gorgeous	`go:dZ@s
gosh	gOS
gossip	`gOs@p
got	gOt
gouge	ga:UdZ
gourmet	`go:ma:I
gout	ga:Ut
govern	`gav@n
government	`gav@nm@nt
governor	`gav@n@
governor-general	gav@n@-`dZEnr@l
gown	ga:Un
gp	dZi:`pi:
gpo	dZi:pi:`@U
grab	grAb
grace	grEIs
gracious	`grEIS@s
grade	grEId
gradual	`grAdZu:@l
graduate	`grAdZu:@t
graffiti	gr@`fi:ti:
graft	gra:ft
grain	grEIn
gram	grAm
grammar	`grAm@
gran	grAn
grand	grAnd
grandchild	`grAntSa:Ild
granddaughter	`grAndo:t@
grandfather	`grAnfa:D@
grandiose	`grAndi:@Us
grandmother	`grAnmaD@
grandparent	`grAnpE@r@nt
grandson	`grAnsan
grandstand	`grAnstAnd
granite	`grAn@t
granny smith	grAni:`smIT
grant	grAnt
grape	grEIp
graph	grAf
graphic	`grAfIk
graphite	`grAfa:It
grapple	`grAp@l
grasp	grAsp
grasping	`grAspIN
grass	gra:s
grassroots	gra:s`ru:ts
grate	grEIt
grateful	`grEItfUl
grater	`grEIt@
grating	`grEItIN
gratitude	`grAt@tSu:d
grave	grEIv
gravel	`grAv@l
graveyard	`grEIvja:d
gravitate	`grAv@tEIt
gravity	`grAv@ti:
gravy	`grEIvi:
graze	grEIz
grazier	`grEIzi:@
grease	gri:s
greaseproof	`gri:spru:f
great	grEIt
greedy	`gri:di:
greek	gri:k
green	gr\i:n
greengrocer	`gri:ngr@Us@
greenhouse	`gri:nha:Us
greet	gri:t
greeting	`gri:tIN
grenade	gr@`nEId
grevillea	gr@`vIli:@
grew	gru:
grey	grEI
grid	grId
grief	gri:f
grievance	`gri:v@ns
grill	grIl
grille	grIl
grim	grIm
grimace	`grIm@s
grime	gra:Im
grin	grIn
grind	gra:Ind
grip	grIp
gripe	gra:Ip
grisly	`grIzli:
gristle	`grIs@l
grit	grIt
grizzle	`grIz@l
groan	gr@Un
grocer	`gr@Us@
groceries	`gr@Us@ri:z
grog	grOg
groggy	`grOgi:
groin	gro:In
groom	gru:m
groomsman	`gru:mzm@n
groove	gru:v
grope	gr@Up
gross	gr@Us
grotesque	gr@U`tEsk
grotty	`grOti:
grouch	gra:UtS
ground	gra:Und
groundwork	`gra:Undw@:k
group	gru:p
grout	gra:Ut
grove	gr\@}v
grovel	`grOv@l
grow	gr@U
growl	gra:Ul
grown	gr@Un
growth	gr@UT
grub	grab
grubby	`grabi:
grudge	gradZ
grudging	`gradZIN
gruelling	`gru:@lIN
gruesome	`gru:s@m
gruff	graf
grumble	`gramb@l
grumpy	`grampi:
grunt	grant
guarantee	gAr@n`ti:
guard	ga:d
guardian	`ga:di:@n
guerilla	g@`rIl@
guess	gEs
guest	gEst
guffaw	ga`fo:
guidance	`ga:Id@ns
guide	ga:Id
guile	ga:Il
guilt	gIlt
guitar	g@`ta:
gulf	galf
gullet	`gal@t
gullible	`gal@b@l
gully	`gali:
gulp	galp
gum	g6m
gumboot	`gambu:t
gun	gan
gurgle	`g@:g@l
gush	gaS
gust	gast
gusto	`gast@U
gut	gat
gutter	`gat@
guy	ga:I
guzzle	`gaz@l
gym	dZIm
gymnasium	dZIm`nEIzi:@m
gymnastics	dZIm`nAstIks
gynaecologist	ga:In@`kOl@dZ@st
gypsy	`dZIpsi:
h	EItS
habit	`hAb@t
habitat	"`hAb@tAt
hack	hAk
hacksaw	"`hAkso:
had	hAd
hadnt	`hAd.nt
haemoglobin	hi:m@"`gl@Ub@n
haemophilia	hi:m@"`fIli:@
haemorrhage	`hEm@rIdZ
haemorrhoid	`hEm@ro:i:d
haggard	`hAg@d
haggle	`hAg@l
hail	hEIl
hair	hE@
hair-raising	`hE@rEIzIN
haircut	`hE@kat
hairdo	`hE@du:
hairdresser	`hE@drEs@
hairstyle	`hE@sta:Il
half	ha:f
half-brother	`ha:f-braD@
half-hearted	`ha:f-ha:t@d
half-sister	`ha:f-sIst@
halfway	`ha:f.wEI
hall	ho:l
hallmark	`ho:lma:k
hallucinate	h@`lu:s@nEIt
hallway	`ho:lwEI
halo	`hEIl@U
halt	ho:lt
halve	ha:v
ham	hAm
hamburger	`hAmb@:g@
hammer	`hAm@
hammock	`hAm@k
hamper	`hAmp@
hamstring	`hAmstrIN
hand	hAnd
handbag	`hAndbAg
handcuffs	`hAndkafs
handful	`hAndfUl
handicap	`hAndIkAp
handicraft	`hAndi:kra:ft
handkerchief	`hANk@tS@f
handle	`hAndl
handmade	h{nm{Id
handout	`hAnda:Ut
hands-on	hAndz-`On
handshake	`hAndSEIk
handsome	`hAns@m
handwriting	`hAndra:ItIN
handy	`hAndi:
hang	hAN
hang-glider	`hAN-gla:Id@
hang-up	`hAN-ap
hangar	`hAN@
hanger	`hAN@
hangover	`hAN@Uv@
hankie	`hANki:
haphazard	hAp`hAz@d
happen	`hAp@n
happy	`hApi:
harass	`hAr@s
harbour	`ha:b@
hard	ha:d
hardly	`ha:dli:
hardship	`ha:dSIp
hardware	`ha:dwE@
hardy	`ha:di:
harm	ha:m
harmony	`ha:m@ni:
harness	`ha:n@s
harp	ha:p
harpoon	ha:`pu:n
harsh	ha:S
harvest	`ha:v@st
has	hAz
hash	hAS
hassle	`hAs@l
haste	hEIst
hat	hAt
hat-trick	`hAt-trIk
hatch	hAtS
hatchback	`hAtSbAk
hatchet	`hAtS@t
hate	hEIt
haughty	`ho:ti:
haul	ho:l
haunt	ho:nt
have	hAv
haven	`hEIv@n
havoc	`hAv@k
hawk	ho:k
hay	hEI
hay fever	`hEIfi:v@
haywire	`hEIwa:I@
hazard	`hAz@d
haze	hEIz
hazel	`hEIz@l
he	hi:
head	hEd
head start	hEd`sta:t
head-on	hEd-`On
headache	`hEdEIk
heading	`hE.dIN
headland	`hEdl@nd
headlight	`hEdla:It
headline	`hEdla:In
headquarters	`hEdkwo:t@z
headstone	`hEdst@Un
headstrong	`hEdstrON
headteacher	`hEdti:tS@
headway	`hEdwEI
headwind	`hEdwInd
heal	hi:l
health	hElT
heap	hi:p
hear	hI@
hearing	`hI@rIN
hearing aid	`hI@rINEId
hearsay	`hI@sEI
hearse	h@:s
heart	ha:t
heartache	`ha:tEIk
heartbreak	`ha:tbrEIk
heartburn	`ha:tb@:n
hearten	`ha:t@n
heartless	`ha:tl@s
hearty	`ha:ti:
heat	hi:t
heater	`hi:.t@
heatwave	`hi:twEIv
heave	hi:v
heaven	`hEv@n
heavy	`hEvi:
heckle	`hEk@l
hectare	`hEktE@
hectic	`hEktIk
hedge	hEdZ
heel	hi:l
hefty	`hEfti:
heifer	`hEf@
height	ha:It
heighten	`ha:It@n
heights	hAets
heir	E@
heirloom	`E@lu:m
held	hEld
helicopter	`hEl@kOpt@
heliport	`hEli:po:t
hell	hEl
hello	ha`l@U
helm	hElm
helmet	`hElm@t
help	hElp
helping	`hElpIN
helpless	`hElpl@s
hem	hEm
hemisphere	`hEm@sfI@
hemline	`hEmla:In
hemp	hEmp
hen	hEn
hence	hEns
henceforth	hEns`fo:T
hepatitis	hEp@`ta:It@s
her	h@:
herald	`hEr@ld
herb	h@:b
herd	h@:d
here	hI@
heredity	h@`rEd@ti:
heresy	`hEr@si:
heritage	`hEr@tIdZ
hermit	`h@:m@t
hernia	`h@:ni:@
hero	`hI@r@U
heroin	`hEr@w@n
heroine	`hEr.@w@n
herpes	`h@:pi:z
hers	h@:z
herself	h@`sElf
hesitate	`hEz@tEIt
heterosexual	hEt@r@U`sEkSu:@l
hew	hju:
heyday	`hEIdEI
hi-fi	`ha:I-fa:I
hibernate	`ha:Ib@nEIt
hiccup	`hIkap
hidden	`hI.dn
hide	ha:Id
hideaway	`ha:Id@wEI
hideous	`hIdi:@s
hierarchy	`ha:I@ra:ki:
high	hAe
high school	`ha:Isku:l
high season	`ha:Isi:z@n
highbrow	`ha:Ibra:U
highland	`ha:Il@nd
highlight	`ha:Ila:It
highlighter	`ha:Ila:It@
highly	`ha:Ili:
highway	`ha:IwEI
hijack	`ha:IdZAk
hike	ha:Ik
hilarious	h@`lE@ri:@s
hill	hIl
hilt	hIlt
him	hIm
himself	hIm`sElf
hind	ha:Ind
hinder	`hInd@
hindsight	`ha:Indsa:It
hinduism	`hIndu:Iz@m
hinge	hIndZ
hint	hInt
hip	hIp
hire	`ha:I@
hire-purchase	ha:I@-`p@:tS@s
his	hIz
hiss	hIs
historic	hI`stO.rIk
historical	hI`stO.rIk@l
history	`hIstri:
hit	hIt
hit-and-run	hIt-n-`ran
hitch	hItS
hitchhike	`hItSha:Ik
hitherto	hID@`tu:
hive	ha:Iv
hoard	ho:d
hoarding	`ho:dIN
hoarse	ho:s
hoax	h@Uks
hobble	`hOb@l
hobby	`hObi:
hobbyhorse	`hObi:ho:s
hockey	`hOki:
hoe	h@U
hog	hOg
hoist	ho:Ist
hold	h@Uld
hold-up	`h@Uld-ap
hole	h@Ul
holiday	`hOl@dEI
hollow	`hOl@U
holocaust	`hOl@kOst
hologram	`hOl@grAm
holster	`h@Ulst@
holy	`h@Uli:
homage	`hOmIdZ
home	h@Um
home unit	`h@Umju:n@t
homeland	`h@UmlAnd
homesick	`h@UmsIk
homestead	`h@UmstEd
homework	`h@Umw@:k
homicide	`hOm@sa:Id
homoeopathy	h@Umi:`Op@Ti:
homogeneous	h@Um@`dZi:ni:@s
homosexual	h@Um@U`sEkSu:@l
honest	`On@st
honey	`hani:
honeycomb	`hani:k@Um
honeymoon	`hani:mu:n
honorary	`On@r@ri:
honour	`On@
honourable	`On@r@b@l
hood	hUd
hoodlum	`hu:dl@m
hoodwink	`hUdwINk
hoof	hu:f
hook	hUk
hooligan	`hu:l@g@n
hoon	hu:n
hoop	hu:p
hop	hOp
hope	h@Up
hopeful	`h@UpfUl
hopeless	`h@Upl@s
horde	ho:d
horizon	h@`ra:Iz@n
horizontal	hOr@`zOntl
hormone	`ho:m@Un
horn	ho:n
horoscope	`hOr@sk@Up
horrendous	h@`rEnd@s
horrible	`hOr@b@l
horrify	`hOr@fa:I
horror	`hOr@
hors doeuvre	o:`d@:v
horse	ho:s
horseshoe	`ho:sSu:
horticulture	`ho:t@kaltS@
hose	h@Uz
hosiery	`h@UZ@ri:
hospice	`hOsp@s
hospital	`hOsp@tl
hospitality	hOsp@`tAl@ti:
host	h@Ust
hostage	`hOstIdZ
hostel	`hOst@l
hostile	`hOsta:Il
hot	hOt
hot chips	hOt`tSIps
hot dog	`hOtdOg
hotel	h@}tel
hothouse	`hOtha:Us
hotline	`hOtla:In
hotplate	`hOtplEIt
hound	ha:Und
hour	r"a:U@
house	h{Os
house-warming	`ha:Us-wo:mIN
housebreaker	`ha:UsbrEIk@
household	`ha:Ush@Uld
housekeeping	`ha:Uski:pIN
housewife	`ha:Uswa:If
housework	`ha:Usw@:k
hovel	`hOv@l
hover	`hOv@
hovercraft	`hOv@kra:ft
how	ha:U
however	ha:U`Ev@
howl	ha:Ul
hq	EItS`kju:.
hr	a:U@
hsc	EItSEs`si:.
ht	ha:It
hub	hab
huddle	`hadl
hue	hju:
hug	hag
huge	hju:dZ
hulk	halk
hull	hal
hullo	`hal@U
hum	ham
human	`hju:m@n
humane	hju:;`mEIn
humanitarian	hju:;mAn@`tE@ri:@n
humanity	hju:`mAn@ti:
humble	`hamb@l
humdrum	`hamdram
humid	`hju:m@d
humiliate	hju:`mIli:EIt
humility	hju:`mIl@ti:
humour	`hju:m@
hump	hamp
humpy	`hampi:
hunch	hantS
hundred	`handr@d
hung	haN
hungarian	haN`gE@ri:@n
hunger	`haNg@
hunt	hant
hurdle	`h@:dl
hurl	h@:l
hurray	h@`rEI
hurricane	`har@k@n
hurry	`hari:
hurt	h@:t
hurtful	`h@:t.fUl
hurtle	`h@:tl
husband	`hazb@nd
hush	haS
husk	hask
husky	`haski:
hustle	`has@l
hut	hat
hutch	hatS
hwy	`ha:IwEI
hybrid	`ha:IbrId
hydrant	`ha:Idr@nt
hydraulic	ha:I`drOlIk
hydro-electric	ha:Idr@U-@`lEktrIk
hydrofoil	`ha:Idr@fo:Il
hydroponics	ha:Idr@`pOnIks
hygiene	`ha:IdZi:n
hymn	hIm
hype	ha:Ip
hyped-up	`ha:Ipt-ap
hyphen	`ha:If@n
hypnosis	hIp`n@Us@s
hypochondriac	ha:Ip@`kOndri:Ak
hypocrite	`hIp@krIt
hypodermic	ha:Ip@`d@:mIk
hypothesis	ha:I`pOT@s@s
hysterectomy	hIst@`rEkt@mi:
hysteria	hIs`tI@ri:@
i	a:I
i.e.	a:I`i:.
ice	a:Is
ice-cream	`a:Is-kri:m
iceberg	`a:Isb@:g
icicle	`a:IsIk@l
icing	`a:IsIN
id	a:I`di:
idea	a:I`dI@
ideal	a:I`di:l
identical	a:I`dEntIk@l
identification	a:I;dEnt@f@`kEI.S@n
identify	a:I`dEnt@fa:I
identity	a:I`dEnt@ti:
idiom	`Idi:@m
idiot	`Idi:@t
idle	`a:Idl
idol	`a:Idl
if	If
ignite	Ig`na:It
ignition	Ig`nIS@n
ignorant	`Ign@r@nt
ignore	Ig`no:
ill	Il
illegal	I`li:g@l
illegible	I`lEdZ@b@l
illegitimate	Il@`dZIt@m@t
illicit	I`lIs@t
illiterate	I`lIt@r@t
illuminate	I`lu:m@nEIt
illusion	I`lu:Z@n
illustrate	`Il@strEIt
image	`ImIdZ
imaginary	I`mAdZ@n@ri:
imagination	ImAdZ@`nEIS@n
imagine	I`mAdZ@n
imam	`Ima:m
imbecile	`Imb@si:l
imitate	`Im@tEIt
immaculate	I`mAkju:l@t
immature	`Im.@tSU@
immediate	I`mi:di:@t
immense	I`mEns
immerse	I`m@:s
immigrant	`Im@gr@nt
imminent	`Im@n@nt
immoral	I`mOr@l
immortal	I`mo:t@l
immune	I`mju:n
impact	`ImpAkt
impair	Im`pE@
impartial	Im`pa:S@l
impatient	Im`pEIS@nt
impede	Im`pi:d
imperative	Im`pE.r@tIv
imperfect	i:m`p@:fEkt
imperial	Im`pI@ri:@l
impersonal	Im`p@:s@n@l
impersonate	Im`p@:s@nEIt
impertinent	Im`p@:t@n@nt
impetuous	Im`pEtju:@s
implement	`Impl@m@nt
implicate	`Impl@kEIt
implication	Impl@`kEIS@n
implicit	Im`plIs@t
implore	Im`plo:
imply	Im`pla:I
impolite	Imp@`la:It
import	Im`po:t
important	Im`po:t@nt
impose	Im`p@Uz
imposing	Im`p@UzIN
impossible	Im`pOs@b@l
imposter	Im`pOst@
impotent	`Imp@t@nt
impress	Im`prEs
impression	Im`prES@n
imprison	Im`prIz@n
improve	Im`pru:v
impudent	`Impju:d@nt
impulse	`Impals
impure	Im`pjU@
in	In
in-	In-
in-laws	`In-lo:z
in-patient	`In-pEIS@nt
inaccurate	I`nA.kjUr@t
inadequate	I`nAd@kw@t
inane	I`nEIn
inanimate	I`nAn@m@t
inappropriate	In@`pr@Upri:@t
incapacitate	Ink@`pAs@tEIt
incentive	In`sEntIv
incessant	In`sEs@nt
incest	`InsEst
inch	IntS
incidence	`Ins@d@ns
incident	`Ins@d@nt
incidental	Ins@`dEntl
incinerate	In`sIn@rEIt
incite	In`sa:It
incline	`INkla:In
inclined	IN`kla:Ind
include	IN`klu:d
inclusive	IN`klu:sIv
incoherent	INk@U`hI@r@nt
income	`Inkam
incoming	`In.kamIN
incompetent	IN`kOmp@t@nt
inconvenient	INk@n`vi:ni:@nt
incorporate	IN`ko:p@rEIt
increase	IN`kri:s
incredible	IN`krEd@b@l
incur	IN`k@:
indebted	In`dEt@d
indecent	In`di:s@nt
indeed	In`di:d
indefinite	In`dEf.n@t
indent	In`dEnt
independent	Ind@`pEnd@nt
index	`IndEks
indicate	`Ind@kEIt
indicator	`Ind@kEIt@
indifferent	In`dIfr@nt
indigenous	In`dIdZ@n@s
indigestion	Ind@`dZEstS@n
indignant	In`dIgn@nt
indispensable	Ind@s`pEns@b@l
indisposed	Ind@s`p@Uzd
indisputable	Ind@s`pju:t@b@l
individual	Ind@`vIdZu:@l
indoctrinate	In`dOktr@nEIt
indolent	`Ind@l@nt
indonesian	Ind@`ni:Z@n
indoors	In`do:z
induce	In`dju:s
indulge	In`daldZ
industry	`Ind@stri:
inept	In`Ept
inevitable	In`Ev@t@b@l
inevitably	In`Ev@t@bli:
inexperience	In@k`spI@ri:@ns
infamous	`Inf@m@s
infant	`Inf@nt
infatuated	In`fAtSu:EIt@d
infection	In`fEk.S@n
infectious	In`fEkS@s
infer	In`f@:
inferior	In`fI@ri:@
infest	In`fEst
infidelity	Inf@`dEl@ti:
infiltrate	`In.f@ltrEIt
infinite	`Inf@n@t
infinitive	In`fIn@tIv
inflame	In`flEIm
inflammable	In`flAm@b@l
inflate	In`flEIt
inflation	In`flEIS@n
inflect	In`flEkt
inflexible	In`flEks@b@l
inflict	In`flIkt
influence	`Influ:@ns
influenza	Influ:`Enz@
influx	`Inflaks
inform	In`fo:m
informal	In`fo:m@l
information	Inf@`mEIS@n
infuriate	In`fju:ri:EIt
ingenious	In`dZi:ni:@s
ingrained	`IngrEInd
ingratiate	In`grEISi:EIt
ingratitude	In`grAt@tSu:d
ingredient	In`gri:di:@nt
inhabit	In`hAb@t
inhale	In`hEIl
inherit	In`hEr@t
initial	I`nIS@l
initiate	I`nISi:EIt
initiative	I`nISi:@tIv
inject	In`dZEkt
injure	`IndZ@
injustice	In`dZast@s
ink	INk
inkling	`INklIN
inlaid	`InlEId
inland	`In.lAnd
inmate	`InmEIt
inner	`In@
innings	`InINz
innocent	`In@s@nt
innumerable	I`nju:m@r@b@l
inoculate	I`nOkju:lEIt
inquest	`INkwEst
inquire	IN`kwa:I@
inquisitive	IN`kwIz@tIv
ins and outs	Inz@n`a:Uts
insane	In`sEIn
insect	`InsEkt
insecticide	In`sEkt@sa:Id
insecure	Ins@`kju:@
insensitive	In`sEns@tIv
insert	In`s@:t
inside	In`sa:Id
insinuate	In`sInju:EIt
insipid	In`sIp@d
insist	In`sIst
insolent	`Ins@l@nt
inspect	In`spEkt
inspire	In`spa:I@
install	In`sto:l
instalment	In`sto:lm@nt
instance	`Inst@ns
instant	`Inst@nt
instead	In`stEd
instinct	`InstINkt
institute	`Inst@tSu:t
institution	Inst@`tju:S@n
instruct	In`strakt
instruction	In`strakS@n
instrument	`Instr@m@nt
insubordinate	Ins@`bo:d@n@t
insubstantial	Ins@b`stAnS@l
insufferable	In`saf@r@b@l
insulate	`InS@lEIt
insulin	`InS@l@n
insult	In`salt
insure	In`So:
intact	In`tAkt
integral	`Int@gr@l
integrate	`Int@grEIt
integrity	In`tEgr@ti:
intellect	`Int@lEkt
intelligence	In`tEl@dZ@ns
intelligent	In`tE.l@dZ@nt
intend	In`tEnd
intense	In`tEns
intensive	In`tEnsIv
intention	In`tEnS@n
interact	Int@r`Akt
intercept	rInt@`sEpt
intercourse	`Int@ko:s
interest	`Intr@st
interesting	`In.tr@stIN
interfere	Int@`fI@
interim	`Int@r@m
interior	In`tI@ri:@
interjection	Int@`dZEkS@n
interlude	`Int@lu:d
intermediate	Int@`mi:di:@t
intermission	Int@`mIS@n
intermittent	Int@`mIt@nt
internal	In`t@:n@l
international	Int@`nAS@n@l
interpret	In`t@:pr@t
interrogate	In`tEr@gEIt
interrogative	Int@`rO.g@tIv
interrupt	Int@`rapt
intersection	`Int@`sEkS@n
interstate	`Int@stEIt
interval	`Int@v@l
intervene	Int@`vi:n
interview	`Int@vju:
intestine	In`tEst@n
intimate	`Int@m@t
intimidate	In`tIm@dEIt
into	`Intu:
intonation	Int@`nEIS@n
intoxicated	In`tOks@kEIt@d
intransitive	In`trAns@tIv
intravenous	Intr@`vi:n@s
intrigue	In`tri:g
introduce	Intr@`dju:s
introduction	Intr@`dakS@n
intrude	In`tru:d
intuition	IntSu:`IS@n
invade	In`vEId
invalid	In`vAl@d
invalid pension	Inv@lId`pEnS@n
invaluable	In`vAlj@b@l
invent	In`vEnt
inverted comma	Inv@:t@d`kOm@
invest	In`vEst
investigate	In`vEst@gEIt
invigorate	In`vIg@rEIt
invisible	In`vIz@b@l
invite	In`va:It
invoice	`Invo:Is
involve	In`vOlv
involved	In`vOlvd
iou	a:I@U`ju:
irate	a:I`rEIt
iris	`a:Ir@s
irk	@:k
iron	`a:I@n
irony	`a:Ir@ni:
irrational	I`rAS@n@l
irregular	I`rEgj@l@
irrelevant	I`rE.l@v@nt
irrigate	`Ir@gEIt
irritate	`Ir@tEIt
is	Iz
islam	`IzlAm
island	`a:Il@nd
isolate	`a:Is@lEIt
issue	`ISu:
it	It
italian	I`tAlj@n
italics	I`tAlIks
itch	ItS
item	`a:It@m
itinerary	a:I`tIn@ri:
its	Its
itself	It`sElf
ive	a:Iv
ivy	`a:I.vi:
j	dZEI
jab	dZAb
jabber	`dZA.b@
jabiru	dZAb@`ru:.
jack	dZAk
jackeroo	dZAk@`ru:
jacket	`dZAk@t
jackknife	`dZAkna:If
jackpot	`dZAkpOt
jade	dZEId
jaded	`dZEId@d
jagged	`dZAg@d
jail	dZEIl
jam	dZAm
jamb	dZIm
jan.	`dZAnju:@ri:
jangle	`dZANg@l
january	`dZAnju:@ri:
japanese	dZAp@`ni:z
jar	dZa:
jargon	`dZa:g@n
jarrah	`dZAr@
jaundice	`dZo:nd@s
jaunt	dZo:nt
jaunty	`dZo:nti:
javelin	`dZAv@l@n
jaw	dZo:
jaywalk	`dZEIwo:k
jazz	dZAz
jealous	`dZEl@s
jeans	dZi:nz
jeep	dZi:p
jeer	dZI@
jelly	`dZEli:
jellyfish	`dZEli:fIS
jeopardy	`dZEp@di:
jerk	dZ@:k
jersey	`dZ@:zi:
jet	dZet
jettison	`dZEt@s@n
jetty	`dZEti:
jewel	`dZu:@l
jewellery	`dZu:@lri:
jewish	`dZu:IS
jibe	dZa:Ib
jiffy	`dZIfi:
jig	dZIg
jiggle	`dZIg@l
jigsaw	`dZIgso:
jillaroo	`dZIl@ru:
jilt	dZIlt
jingle	`dZINg@l
jinx	dZINks
jitters	`dZIt@z
jive	dZa:Iv
jnr	`dZu:nj@
job	dZOb
jobless	`dZObl@s
jockey	`dZOki:
jocular	`dZOkj@l@
jodhpurs	`dZOdp@z
joey	`dZ@Ui:
jog	dZOg
join	dZo:In
joiner	`dZo:In@
joint	dZo:Int
joist	dZo:Ist
joke	dZ@Uk
joker	`dZ@Uk@
jolly	`dZOli:
jolt	dZ@Ult
jostle	`dZOs@l
jot	dZOt
jotter	`dZOt@
joule	dZu:l
journal	`dZ@:n@l
journalist	`dZ@:n@l@st
journey	`dZ@:ni:
jovial	`dZ@Uvi:@l
joy	dZo:I
jp	dZEI`pi:
jube	dZu:b
jubilant	`dZu:b@l@nt
jubilee	dZu:b@`li:
judaism	`dZu:dEIz@m
judge	dZadZ
judgment	`dZadZm@nt
judicial	dZu:`dIS@l
judicious	dZu:`dIS@s
judo	`dZu:d@U
jug	dZag
juggle	`dZag@l
juice	dZu:s
jukebox	`dZu:kbOks
jul.	dZ@`la:I
july	dZ@`la:I
jumble	`dZamb@l
jumbo	`dZamb@U
jumbuck	`dZambak
jump	dZamp
jumper	`dZamp@
jumpy	`dZampi:
jun.	dZu:n
junction	`dZaNkS@n
juncture	`dZaNktS@
june	dZu:n
jungle	`dZaNg@l
junior	`dZu:nj@
junk	dZaNk
junkie	`dZaNki:
junta	`dZant@
jurisdiction	dZu:r@s`dIkS@n
jury	`dZu:ri:
just	dZast
justice	`dZast@s
justice of the peace	`dZast@s@vD@pi:s
justify	`dZast@fa:I
jut	dZat
jute	dZu:t
juvenile	`dZu:v@na:Il
juxtapose	dZakst@`p@Uz
k	kEI
kaleidoscope	k@`la:Id@sk@Up
kangaroo	kANg@`ru:
karate	k@`ra:ti:
kayak	`ka:IAk
kebab	k@`bAb
keel	ki:l
keen	ki:n
keep	ki:p
keeper	`ki:p@
keeping	`ki:pIN
keepsake	`ki:psEIk
keg	kEg
kelp	kElp
kennel	`kEn@l
kept	kEpt
kerb	k@:b
kernel	`k@:n@l
kero	`kEr@U
kerosene	kEr@`si:n
ketchup	`kEtS@p
kettle	`kEtl
key	ki:
keyboard	`ki:bo:d
keynote	`ki:n@Ut
kg	kEI`dZi:
khaki	ka:`ki:
khmer	k@`mE@
kibble	`kIb@l
kick	kIk
kid	kId
kidnap	`kIdnAp
kidney	`kIdni:
kill	kIl
killing	`kIlIN
kiln	kIln
kilo	`ki:l@U
kilobyte	`kIl@ba:It
kilogram	`kIl@grAm
kilohertz	`kIl@h@:ts
kilojoule	`kIl@dZu:l
kilometre	k@`lOm@t@
kilowatt	`kIl@wOt
kilt	kIlt
kimono	`kIm@n@U
kin	kIn
kind	ka:Ind
kindergarten	`kInd@ga:tn
kindle	`kInd@l
kindling	`kIndlIN
kindly	`ka:Indli:
kindred	`kIndr@d
kindy	`kIndi:
king	kIN
kingdom	`kINd@m
kink	kINk
kinship	`kInSIp
kiosk	`ki:Osk
kiss	kIs
kit	kIt
kitchen	`kItS@n
kitchen tea	kItS@n`ti:
kitchenette	kItS@`nEt
kite	ka:It
kitsch	kItS
kitten	`kItn
kiwi	`ki:wi:
kj	`kIl@dZu:l
kleptomania	klEpt@`mEIni:@
km	k@`lOm@t@
knack	nAk
knackered	`nAk@d
knapsack	`nApsAk
knave	nEIv
knead	ni:d
knee	ni:
kneecap	`ni:kAp
kneel	ni:l
knew	nju:
knick-knack	`nIk-nAk
knickers	`nIk@z
knife	na:If
knight	na:It
knit	nIt
knitting	nItIN
knob	nOb
knock	nOk
knot	nOt
know	n@U
knowing	`n@UIN
knowledge	`nOlIdZ
known	n@Un
knuckle	`nak@l
ko	kEI`@U
koala	k@6:l@
kookaburra	`kUk@bar@
korean	k@`ri:@n
kosher	`k@US@
kung-fu	kaN-`fu:
l	El
l-plate	`El.-plEIt
la	lEIn
label	`lEI.b@l
labor	`lEIb@
labor party	`lEIb@pa:ti:
laboratory	l@`bOr@tri:
labour	`lEIb@
lace	lEIs
lacerate	`lAs@rEIt
lack	lAk
lacquer	`lAk@
lad	lAd
ladder	`lAd@
lady	`lEIdi:
lag	lAg
lager	`la:.g@
lagoon	l@`gu:n.
laid	lEId
lake	lEIk
lamb	lAm
lame	lEIm
laminate	`lAm@nEIt
lamington	`lAmINt@n
land	lAnd
landlady	`lAndlEIdi:
landlord	`lAndlo:d
landmark	`lAnd.ma:k
landscape	`lAndskEIp
landslide	`lAndsla:Id
lane	l{In
language	`lANwIdZ
lank	lANk
lanky	`lANki:
lantern	`lAnt@n
lao	la:U
lap	lAp
lapse	lAps
large	la:dZ
larrikin	`lAr@k@n
laryngitis	lAr@n`dZa:It@s
larynx	`lArINks
laser	`lEIz@
lash	lAS
last	la:st
latch	lAtS
late	lEIt
lately	`lEItli:
later	`lEI.t@
latest	`lEI.t@st
lather	`lA.D@
latin	`lAt.n
latitude	`lA.t@tSu:d
latter	`lAt@
lattice	`lA.t@s
laugh	la:f
launch	lo:ntS
laundromat	`lo:ndr@mAt
laundry	`lo:ndri:
lavatory	`lA.v@tri:
lavender	`lAv@nd@
lavish	`lA.vIS
law	lo:
lawful	`lo:f@l
lawn	lo:n
lawnmower	`lo:nm@U@
lawyer	`lo:.j@
lax	lAks
laxative	`lAk.s@tIv
lay	lEI
lay-by	`lEI.-ba:I
layer	`lEI.@
layout	`lEI.a:Ut
lazy	`lEI.zi:
lead	li:d
leader	`li:.d@
leaf	li:f
league	li:g
leak	li:k
lean	li:n
leant	lEnt
leap	li:p
leapt	lEpt
learn	l@:n
lease	li:s
leash	li:S
least	li:st
leather	`lED@
leave	li:v
lecture	`lEktS@
led	lEd
ledge	lEdZ
ledger	`lE.dZ@
leer	lI@
left	lEft
left-handed	lEft-`hAnd@d
leg	lEg
legal	`li:g@l
legend	`lE.dZ@nd
leggings	`lEg.INz
legible	`lE.dZ@b@l
legislation	lEdZ@`slEI.S@n
legitimate	l@`dZI.t@m@t
leisure	`lE.Z@
lemon	`lE.m@n
lemonade	lEm@`nEId.
lend	lEnd
length	lENT
lengthen	`lEN.T@n
lenient	`li:.ni:@nt
lens	lEnz
lent	lEnt
leotard	`li:.@ta:d
lesbian	`lEz.bi:@n
less	lEs
lessen	`lE.s@n
lesson	`lE.s@n
let	lEt
lethal	`li:.T@l
letter	`lE.t@
leukaemia	lu:`ki:.mi:@
level	`lE.v@l
lever	`li:.v@
levy	`lE.vi:
liability	la:I@`bI.l@ti:
liable	`la:I.@b@l
liaison	li:`EI.z@n
liar	`la:I.@
libel	`la:I.b@l
liberal	`lI.br@l
liberal party of australia	r;lI.br@lpa:ti:@vOs`trEIl.j@
liberate	`lI.b@rEIt
liberty	`lI.b@ti:
library	`la:I.bri:
lice	la:Is
licence	`la:I.s@ns
lick	lIk
licorice	`lI.k@rIS
lid	lId
lie	la:I
life	la:If
lifelong	`la:If.lON
lifesaver	`la:If.sEIv@
lifetime	`la:If.ta:Im
lift	lIft
light	la:It
lightning	`la:It.nIN
like	la:Ik
likely	`la:I.kli:
limb	lIm
lime	la:Im
limelight	`la:Im.la:It
limestone	`la:Im.st@Un
limit	`lI.m@t
limited company	.;lI.m@t@d`kam.p@ni:
limp	lImp
line	la:In
linen	`lI.n@n
liner	`la:I.n@
linger	`lIN.g@
lingerie	`lOn.Z@rEI
linguistic	lIN`gwI.stIk
liniment	`lI.n@m@nt
lining	`la:I.nIN
link	lINk
linoleum	l@`n@U.li:@m
linseed oil	;lIn.si:d`o:Il.
lip	lIp
lipstick	`lIp.stIk
liquefy	`lI.kw@fa:I
liqueur	l@`kju:.@
liquid	`lIk.w@d
liquidate	`lI.kw@dEIt
liquor	`lI.k@
lisp	lIsp
list	lIst
listen	`lI.s@n
listless	`lIst.l@s
lit	lIt
literal	`lI.tr@l
literary	`lI.t@r@ri:
literate	`lI.t@r@t
literature	`lI.tr@tS@
litre	`li:.t@
litter	`lI.t@
litterbug	`lI.t@bag
little	`lIt.l
live	lIv
livelihood	`la:Iv.li:;hUd.
lively	`la:Iv.li:
liver	`lI.v@
livestock	`la:Iv.stOk
livid	`lI.v@d
living	`lI.vIN
lizard	`lI.z@d
load	l@Ud
loaf	l@Uf
loam	l@Um
loan	l@Un
loath	l@UT
loathe	l@UD
lob	lOb
lobby	`lO.bi:
local	`l@U.k@l
locate	l@`kEIt.
lock	lOk
locker	`lO.k@
locket	`lO.k@t
locksmith	`lOk.smIT
locomotive	l@Uk@`m@U.tIv
lodge	lOdZ
loft	lOft
lofty	`lOf.ti:
log	lOg
logical	`lO.dZIk@l
loiter	`lo:I.t@
lolly	`lO.li:
lone	l@Un
lonely	`l@Un.li:
long	lON
longitude	`lON.g@tSu:d
look	lUk
lookout	`lUk.a:Ut
loom	lu:m
loop	lu:p
loophole	`lu:p.h@Ul
loose	lu:s
loot	lu:t
lop	lOp
lopsided	lOp`sa:I.d@d
lord	lo:d
lorry	`lO.ri:
lose	lu:z
loss	lOs
lost	lOst
lot	lOt
lotion	`l@U.S@n
lottery	`lO.t@ri:
lotto	`lO.t@U
loud	la:Ud
loudspeaker	la:Ud`spi:k@.
lounge	la:UndZ
louse	la:Us
lousy	`la:U.zi:
lout	la:Ut
love	lav
lovely	`lav.li:
low	l@U
lower	`l@U.@
loyal	`lo:I.@l
lozenge	`lO.z@ndZ
lpg	Elpi:`dZi:.
ltd	`lI.m@t@d
lubricate	`lu:.br@kEIt
lucid	`lu:.s@d
luck	lak
lucrative	`lu:.kr@tIv
ludicrous	`lu:.d@kr@s
lug	lag
luggage	`la.gIdZ
lukewarm	lu:k`wo:m.
lull	lal
lullaby	`la.l@ba:I
luminous	`lu:.m@n@s
lump	lamp
lunar	`lu:.n@
lunatic	`lu:.n@tIk
lunch	lantS
lung	laN
lunge	landZ
lurch	l@:tS
lurgy	`l@:.gi:
lurid	`lu:.r@d
lurk	l@:k
luscious	`la.S@s
lush	laS
lust	last
luxuriant	lag`Zu:.ri:@nt
luxury	`lak.S@ri:
lying	la:I.;IN
lyrebird	`la:I@.b@:d
m	Em
macabre	m@`ka:b
macadamia	mAk@`dEImi:@
macaroni	mAk@`r@Uni:
macedonian	mAs@`d@Uni:@n
machete	m@`SEti:
machine	m@`Si:n
machinery	m@`S@i:n@ri:
macho	`mAtS@U
mad	mAd
madam	`mAd@m
made	mEId
magazine	mAg@`zi:n
maggot	`mAg@t
magic	`mAdZIk
magistrate	`mAdZ@strEIt
magnanimous	mAg`nAn@m@s
magnate	`mAgnEIt
magnet	`mAgn@t
magnificent	mAg`nIf@s@nt
magnify	`mAgn@fa:I
magnifying glass	`mAgn@fa:IINgla:s
magnitude	`mAgn@tSu:d
magpie	`mAgpa:I
maiden	`mEIdn
mail	mEIl
mail order	`mEIlo:d@
maim	mEIm
main	mEIn
mainland	`mEInlAnd
mainstream	`mEInstri:m
maintain	mEIn`tEIn
maitre dhotel	mEItr@d@U`tEl
maize	mEIz
majesty	`mAdZ@sti:
major	`mEIdZ@
majority	m@`dZOr@ti:
make	mEIk
make-believe	`mEIk-b@li:v
make-up	`mEIk-ap
maladjusted	mAl@`dZast@d
malaria	m@`lE@ri:@
male	mEIl
malevolent	m@`lEv@l@nt
malformation	mAlfo:`mEIS@n
malice	`mAl@s
malign	m@`la:In
malignant	m@`lIgn@nt
malinger	m@`lINg@
mall	mo:l
malleable	`mAli:@b@l
mallee	`mAli:
mallet	`mAl@t
malnourished	`mAlnarISt
malpractice	mAl`prAkt@s
malt	mOlt
maltreat	mAl`tri:t
mammal	`mAm@l
mammoth	`mAm@T
man	mAn
manage	`mAnIdZ
management	`mAnIdZm@nt
manager	`mAn@dZ@
manchester	`mAntS@st@
mandarin	`mAnd@r@n
mandate	`mAndEIt
mandatory	`mAnd@tri:
mane	mEIn
mange	mEIndZ
mangle	`mANg@l
mangrove	`mANgr@Uv
mania	`mEIni:@
maniac	`mEIni:Ak
manicure	`mAn@kjU@
manifest	`mAn@f@st
manifesto	mAn@`fEst@U
manipulate	m@`nIpj@lEIt
mankind	mAn`ka:Ind
manly	`mAnli:
manner	`mAn@
mannerism	`mAn@rIz@m
manoeuvre	m@`nu:v@
manor	m{n@
mansion	`mAnS@n
manslaughter	`mAnslo:t@
manta	m{nt@
mantlepiece	`mAntlpi:s
manual	`mAnju:@l
manufacture	mAnj@`fAktS@
manure	m@`njU@
manuscript	`mAnj@skrIpt
many	`mEni:
map	mAp
marathon	`mAr@TOn
marble	`ma:b@l
march	ma:tS
mare	mE@
margarine	ma:dZ@`ri:n
margin	`ma:dZ@n
marginal	`ma:dZ@n@l
marijuana	mAr@`wa:n@
marina	m@`ri:n@
marinate	`mAr@nEIt
marine	m@`ri:n
marital	`mAr@t@l
maritime	`mAr@ta:Im
mark	ma:k
mark-up	`ma:k-ap
market	`ma:k@t
marketing	`ma:k@tIN
marmalade	`ma:m@lEId
maroon	m@`ru:n
marquee	ma:`ki:
marriage	`mArIdZ
married	`mAri:d
marrow	`mAr@U
marry	`mAri:
marsh	ma:S
marshal	`ma:S@l
marshmallow	ma:S`mAl@U
marsupial	ma:`sju:pi:@l
martyr	`ma:t@
marvel	`ma:v@l
mascara	mAs`ka:r@
mascot	`mAskOt
masculine	`mAskj@l@n
mash	mAS
mask	ma:sk
mason	`mEIs@n
masonry	`mEIs@nri:
masquerade	mAsk@`rEId
mass	mAs
massacre	`mAs@k@
massage	`mAsa:Z
massive	`mAsIv
mast	ma:st
mastectomy	mAs`tEkt@mi:
master	`ma:st@
masterpiece	`ma:st@pi:s
masturbate	`mAst@bEIt
mat	mAt
match	mAtS
mate	mEIt
material	m@`tI@ri:@l
materialise	m@`tI@ri:@la:Iz
materialistic	m@tI@ri:@`lIstIk
maternal	m@`t@:n@l
maternity	m@`t@:n@ti:
mathematics	mAT@`mAtIks
maths	mATs
matriarch	`mEItri:a:k
matrimony	`mAtr@m@ni:
matt	mAt
matter	`mAt@
mattress	`mAtr@s
mature	m@`tSo:.
maul	mo:l
mauve	m@Uv
maverick	`mAv@rIk
maxim	`mAks@m
maximum	`mAks@m@m
may	mEI
maybe	`mEIbi:
mayonnaise	mEI@`nEIz
mayor	mE@
maze	mEIz
me	mi:
meagre	`mi:g@
meal	mi:l
mean	mi:n
meander	mi:`And@
means	mi:nz
meantime	`mi:nta:Im
meanwhile	`mi:nwa:Il
measles	`mi:z@lz
measure	`mEZ@
meat	mi:t
mechanic	m@`kAnIk
mechanical	m@`kAnIk@l
mechanics	m@`kAnIks
mechanise	`mEk@na:Iz
mechanism	`mEk@nIz@m
medal	`mEdl
medallion	m@`dAlj@n
meddle	`mEdl
media	`mi:di:@
median	`mi:di:@n
mediate	`mi:di:EIt
medical	`mEdIk@l
medicare	`mEdi:kE@
medicine	`mEd@s@n
mediocre	mi:di:`@Uk@
meditate	`mEd@tEIt
medium	`mi:di:@m
medley	`mEdli:
meek	mi:k
meet	mi:t
meeting	`mi:tIN
megabyte	`mEg@ba:It
megaphone	`mEg@f@Un
melancholy	`mEl@nkOli:
melanoma	mEl@`n@U.m@
melba	melb@
mellow	`mEl@U
melodrama	`mEl@dra:m@
melody	`mEl@di:
melon	`mEl@n
melt	mElt
member	`mEmb@
membrane	`mEmbrEIn
memento	m@`mEnt@U
memo	`mEm@U
memoirs	`mEmwa:z
memorable	`mEmr@b@l
memorial	m@`mo:ri:@l
memorise	`mEm@ra:Iz
memory	`mEm@ri:
men	mEn
menace	`mEn@s
mend	mEnd
menial	`mi:ni:@l
menopause	`mEn@po:z
menstruate	`mEnstru:a:It
mental	`mEntl
mention	`mEnS@n
menu	`mEnju:
mercenary	`m@:s@nri:
merchandise	`m@:tS@nda:Is
mercury	`m@:kj@ri:
mercy	`m@:si:
mere	mI@
merge	m@:dZ
meringue	m@`rAN
merino	m@`ri:n@U
merit	`mEr@t
mermaid	`m@:mEId
merry	`mEri:
merry-go-round	`mEri:-g@U-ra:Und
mesh	mES
mesmerise	`mEzm@ra:Iz
mess	mEs
message	`mEsIdZ
messenger	`mE.s@ndZ@
metabolism	m@`tAb@lIz@m
metal	`mEtl
metamorphosis	mEt@`mo:f@s@s
metaphor	`mEt@f@
meteor	`mi:ti:@
meteorite	`mi:ti:@ra:It
meteorologist	mi:ti:@`rOl@dZ@st
meter	`mi:t@
methadone	`mET@d@Un
metho	`mET@U
method	`mET@d
methodical	m@`TOdIk@l
methylated spirits	`mET@lEIt@d`spIr@ts
meticulous	mE`tIkj@l@s
metre	`mi:t@
metric	`mEtrIk
metropolitan	mEtr@`pOl@t@n
mezzanine	`mEz@ni:n
mice	ma:Is
microbe	`ma:Ikr@Ub
microphone	`ma:Ikr@f@Un
microscope	`ma:Ikr@sk@Up
microwave oven	ma:Ikr@wEIv`av@n
mid	mId
midday	`mIddEI
middle	`mIdl
midget	`mIdZ@t
midnight	`mIdna:It
midriff	`mIdrIf
midwife	`mIdwa:If
might	ma:It
mighty	`ma:Iti:
migraine	`ma:IgrEIn
migrant	`ma:Igr@nt
migrate	`ma:I.grEIt
mild	ma:Ild
mildew	`mIldju:
mile	mAel
militant	`mIl@t@nt
military	`mIl@tri:
militia	m@`lIS@
milk	mIlk
milk bar	`mIlkba:
milkshake	`mIlkSEIk
mill	mIl
millennium	m@`lEni:@m
millibar	`mIli:ba:
milligram	`mIl@grAm
millilitre	`mIl@li:t@
millimetre	`mIl@mi:t@
milliner	`mIl@n@
million	`mIlj@n
mime	ma:Im
mimic	`mImIk
mince	mIns
mincemeat	`mInsmi:t
mind	ma:Ind
mindful	`ma:Indf@l
mindless	`ma:Indl@s
mine	ma:In
miner	`ma:In@
mineral	`mIn@r@l
mineral water	`mIn@r@lwo:t@
mingle	`mINg@l
miniature	`mIn@tS@
minimal	`mIn@m@l
minimum	`mIn@m@m
minister	`mIn@st@
minor	`ma:In@
minority	ma:I`nOr@ti:
mint	mInt
minus	`ma:In@s
minute	ma:I`nju:t
miracle	`mIr@k@l
mirage	m@`ra:Z
mire	`ma:I@
mirror	`mIr@
mirth	m@:T
misadventure	mIs@d`vEntS@
misbehave	mIsb@`hEIv
miscarriage	mIs`kArIdZ
miscellaneous	mIs@`lEIni:@s
mischief	`mIstS@f
misdemeanour	mIsd@`mi:n@
miser	`ma:Iz@
miserable	`mIzr@b@l
misery	`mIz@ri:
misfortune	mIs`fo:tS@n
mishap	`mIshAp
mislay	mIs`lEI
mislead	mIs`li:d
miss	mIs
missile	`mIsa:Il
missing	`mIsIN
mission	`mIS@n
missionary	`mI.S@nri:
mist	mIst
mistake	m@`stEIk
mistaken	m@`stEIk@n
mistress	`mIstr@s
misunderstand	mIsand@`stAnd.
mitigate	`mIt@gEIt
mitten	`mItn
mix	mIks
mix-up	`mIks-ap
mixed-up	`mIkst-ap
mixture	`mIkstS@
mnemonic	n@`mOnIk
moan	m@Un
mob	mOb
mobile	`m@Uba:Il
mobilise	`m@Ub@la:Iz
mock	mOk
modal	`m@Udl
mode	m@Ud
model	`mOdl
moderate	`mOdr@t
modern	`mOdn
modest	`mOd@st
modify	`mOd@fa:I
module	`mOdZu:l
moist	mo:Ist
molar	`m@Ul@
mole	m@Ul
molecule	`mOl@kju:l
molest	m@`lEst
molten	`m@Ultn
moment	`m@Um@nt
momentary	`m@u:m@ntri:
momentous	m@`mEnt@s
monarch	`mOn@k
monastery	`mOn@stri:
monday	`mandEI
money	`mani:
mongrel	`maNgr@l
monitor	`mOn@t@
monk	maNk
monkey	`maNki:
mono	`mOn@U
monogamy	m@`nOg@mi:
monogram	`mOn@grAm
monolith	`mOn@lIT
monologue	`mOn@lOg
monopoly	m@`nOp@li:
monosodium glutamate	`mOn@s@Udi:@m`glu:t@mEIt
monotonous	m@`nOt@n@s
monotreme	`mOn@tri:m
monsoon	mOn`su:n
monster	`mOnst@
monstrous	`mOnstr@s
month	manT
monument	`mOnj@m@nt
monumental	mOnj@`mEntl
mood	mu:d
moody	`mu:di:
moon	mu:n
moor	mo:
mooring	`mo:rIN
mop	mOp
mope	m@Up
moral	`mOr@l
morale	m@`ra:l
moratorium	mOr@`to:ri:@m
morbid	`mo:b@d
more	mo:
moreover	mo:r`@Uv@
morgue	mo:g
mornay	`mo:nEI
morning	`mo:nIN
moron	`mo:rOn
morose	m@`r@Us
morphine	`mo:fi:n
morsel	`mo:s@l
mortal	`mo:tl
mortality	mo:`tAl@ti:
mortar	`mo:t@
mortgage	`mo:gIdZ
mortified	`mo:t@fa:Id
mortuary	`mo:tS@ri:
mosaic	m@`zEIIk
mosque	mOsk
moss	mOs
most	m@Ust
mostly	`m@Ustli:
motel	m@U`tEl.
mother	`maD@
mother-in-law	`maD@r-@n-lo:
mother-of-pearl	maD@r-@v-`p@:l
motif	m@U`ti:f
motion	`m@US@n
motivate	`m@Ut@vEIt
motive	`m@UtIv
motor	`m@Ut@
motorbike	`m@U.t@ba:Ik
motorcycle	`m@Ut@sa:Ik@l
motorist	`m@Ut@r@st
mottled	`mOtld
motto	`mOt@U
mould	m@Uld
moult	m@Ult
mound	ma:Und
mount	ma:Unt
mountain	`ma:Unt@n
mountaineer	ma:Unt@`nI@
mourn	mo:n
mouse	ma:Us
mousse	mu:s
moustache	m@`sta:S
mousy	`ma:Usi:
mouth	ma:UT
mouth-watering	`ma:UT-wo:t@rIN
move	mu:v
movement	`mu:vm@nt
movie	`mu:vi:
mow	m@U
mp	Em`pi:.
mr	`mIst@
mrs	`mIs@z
ms	Em`Es
msg	EmEs`dZi:
much	matS
muck	mak
mucus	`mju:k@s
mud	mad
muddle	`madl
mudguard	`madga:d
muesli	`mju:zli:
muffin	`maf@n
muffler	`mafl@
mug	mag
muggy	`magi:
mulch	maltS
mulga	`malg@
mull	mal
multicultural	malti:`kaltS@r@l
multimedia	malti:`mi:di:@
multinational	malti:`nAS@n@l
multiple	`malt@p@l
multiple sclerosis	malt@p@lskl@`r@Us@s
multiple-choice	`malt@pl-tSo:Is.
multiply	`malt@pla:I
multiracial	malti:`rEIS@l
multitude	`mal.t@tSu:d
mum	mam
mumble	`mamb@l
mummy	`mami:
mumps	mamps
munch	mantS
mundane	man`dEIn
municipality	mju:n@s@`pAl@ti:
mural	`mju:r@l
murder	`m@:d@
murky	`m@:ki:
murmur	`m@:m@
muscle	`mas@l
museum	mju:`zi:@m
mush	maS
mushroom	`maSru:m
music	`mju:zIk
musical	`mju:zIk@l
musk	mask
must	mast
mustard	`mast@d
muster	`mast@
musty	`masti:
mutate	mju:`tEIt
mute	mju:t
mutilate	`mju:t@lEIt
mutiny	`mju:t@ni:
mutter	`mat@
mutton	`matn
mutual	`mju:tSu:@l
muzzle	`maz@l
my	ma:I
myopia	ma:I`@Upi:@
myriad	`mIri:@d
myself	ma:I`sElf
mysterious	m@s`tI@ri:@s
mystery	mIstr\i:
mystic	`mIstIk
mystify	`mIst@fa:I
myth	mIT
mythology	m@`TOl@dZi:
n	En
n/a	En`EI
nag	nAg
nail	nEIl
naive	na:I`i:v
naked	`nEIk@d
name	nEIm
nap	nAp
napkin	`nApk@n
nappy	`nApi:
narcotic	na:`kOtIk
narration	n@`rEIS@n
narrative	`nAr@tIv
narrow	`nAr@U
nasal	`nEIz@l
nasty	`na:sti:
nation	`nEIS@n
national	`nASn@l
nationalise	`nASn@la:Iz
nationalism	`nASn@lIzm
native	`nEItIv
natter	`nAt@
natty	`nAti:
natural	`nAtS@r@l
naturalised	`nAtS@r@la:Izd
nature	`nEItS@
naughty	`no:ti:
nausea	`no:si:@
navel	`nEIv@l
navigate	`nAv@gEIt
navy	`nEIvi:
nb	En`bi:
ne	no:T`i:st
near	nI@
nearby	nI@`ba:I
nearly	`nI@li:
neat	ni:t
necessary	`nEs@s@ri:
neck	nEk
necklace	`nEkl@s
nee	nEI
need	ni:d
needle	`ni:dl
negative	`nEg@tIv
neglect	n@`glEkt
negligee	`nEgl@ZEI
negligent	`nEgl@dZ@nt
negligible	`nEgl@dZ@bl
negotiable	nE`g@USi:@bl
negotiate	n@`g@USi:;EIt
neighbour	`nEIb@
neither	`na:ID@
nephew	`nEfju:
nerd	n@:d
nerve	n@:v
nervous	`n@:v@s
nest	nEst
net	nEt
netball	`nEtbo:l
nettle	`nEtl
network	`nEtw@:k
neurotic	nju:`rOtIk
neuter	`nju:t@
neutral	`nju:tr@l
never	`nEv@
nevertheless	nEv@D@`lEs
new	nj}:
newington	nj}:INt@n
news	nju:z
newsagent	`nju:zEIdZ@nt
newspaper	`nju:zpEIp@
next	nEkst
next of kin	nEkst@v`kIn.
nib	nIb
nibble	`nIbl
nice	na:Is
niche	ni:S
nick	nIk
nickname	`nIknEIm
nicotine	nIk@`ti:n
niece	ni:s
nifty	`nIfti:
night	na:It
nightclothes	`na:Itkl@UDz
nightdress	`na:ItdrEs
nightmare	`na:ItmE@
nightshirt	`na:ItS@:t
nil	nIl
nimble	`ni:mbl
nine	na:In
nineteen	na:In`ti:n
nineteenth	na:In`ti:nT
ninety	`na:Inti:
ninth	na:InT
nip	nIp
nippers	`nI.p@z
nipple	`nIpl
nit	nIt
no	n@}
no-one	`n@Uwan
no.	`namb@
noble	`n@Ubl
nobody	`n@UbOdi:
nocturnal	nOk`t@:n@l
nod	nOd
nodule	`nOdju:l
noise	no:Iz
nominate	`nOm@nEIt
nonchalant	`nOnS@l@nt
nondescript	`nOnd@skrIpt
none	nan
nonentity	nOn`Ent@ti:
nonetheless	nanD@`lEs
nonfiction	nOn`fIkS@n
nonflammable	nOn`flAm@bl
nonplussed	nOn`plast
nonsense	`nOns@ns
noodle	n}:d@l
noon	nu:n
noose	nu:s
nor	no:
normal	`no:m@l
north	no:T
northward	`no:T.w@d
nose	n@Uz
nostalgia	nOs`tAldZ@
nostril	`nOstr@l
not	nOt
notable	`n@Ut@bl
notch	nOtS
note	n@Ut
nothing	`naTIN
notice	`n@Ut@s
notify	`n@Ut@fa:I
notion	`n@US@n
notorious	n@`to:ri:@s
nought	no:t
noun	na:Un
nourish	`narIS
nov.	n@`vEmb@
novel	`nOv@l
novelty	`nOv@lti:
november	n@`vEmb@
now	na:U
noxious	`nOkS@s
nozzle	`nOzl
nsw	;nju:sa:UT`wEIlz
nt	;no:D@n`tEr@tri:
nuclear	`nju:kli:@
nucleus	`nju:kli:@s
nude	nju:d
nudge	nadZ
nugget	`nag@t
nuisance	`nju:s@ns
numb	nam
number	`nam@
numberplate	`namb@plEIt
numeral	`nju:m@r@l
numerator	`nju:m@rEIt@
numerous	`nju:m@r@s
nun	nan
nurse	n@:s
nursery	`n@:s@ri:
nut	nat
nutrition	nju:`trIS@n
nutritionist	nju:`trIS@ni:st
nw	no:T`wEst
nylon	`na:IlOn
o	@U
oaf	@Uf
oaks	@}ks
oar	o:
oath	@UT
obedient	@`bi:di:@nt
obese	@U`bi:s
obey	@U`bEI
object	`ObdZEkt
objective	@b`dZEktIv
oblige	@`bla:IdZ
oblong	`OblON
obscene	@b`si:n
obscure	@b`skju:@
observe	@b`z@:v
obsession	@b`sES@n
obsolete	`Obs@li:t
obstacle	`Obst@k@l
obstetrician	Obst@`trIS@n
obstinate	`Obst@n@t
obstruct	@b`strakt
obtain	@b`tEIn
obtuse	@b`tju:s
obvious	`Obvi:@s
occasion	@`kEIZ@n
occasional	@`kEIZ@n@l
occupation	Okj@`pEIS@n
occupied	`Okj@pa:Id
occupy	`Okj@pa:I
occur	@`k@:
ocean	`@US@n
oclock	@`klOk
october	Ok`t@Ub@
odd	Od
odious	`@Udi:@s
odour	`@Ud@
of	Ov
off	Of
off-colour	Of-`kal@
off-peak	`Of-pi:k
off-putting	`Of-pUtIN
offence	@`fEns
offensive	@`fEnsIv
offer	`Of@
office	`Of@s
officer	`Of@s@
offices	Of@s@z
official	@`fIS@l
often	`Of@n
oh	@U
oil	o:Il
ointment	`o:Intm@nt
ok	@U`kEI
okay	@U`kEI
old	@Uld
old age	@Uld`EIdZ
old-fashioned	@Uld-`fAS@nd
olive	`Ol@v
olympic games	@lImpIk`gEImz
ombudsman	`Omb@dzm@n
omelette	`Oml@t
omen	`@Um@n
ominous	`Om@n@s
omit	@U`mIt
on	On
once	wans
oncoming	`OnkamIN
one	w6n
only	`@Unli:
onset	`OnsEt
onto	`Ont@
ooze	u:z
opal	`@Up@l
opaque	@U`pEIk
open	`@Up@n
open-minded	`@Up@n-ma:Ind@d
opera	`Opr@
operate	`Op@rEIt
ophthalmologist	OfTAl`mOl@dZ@st
opinion	@`pInj@n
opponent	@`p@Un@nt
opportunity	Op@`tju:n@ti:
oppose	@`p@Uz
opposite	`Op@s@t
oppression	@`prES@n
optician	Op`tIS@n
optimism	`Opt@mIz@m
option	`OpS@n
optometrist	Op`tOm@tr@st
or	o:
oral	`Or@l
orange	Or\IndZ
orator	`Or@t@
orchard	`o:tS@d
orchestra	`o:k@str@
ordeal	o:`di:l
order	`o:d@
ordinal number	o:d@n@l`namb@
ordinary	`o:d@n@ri:
organ	`o:g@n
organic	o:`gAnIk
organisation	o:g@na:I`zEIS@n
organise	`o:g@na:Iz
organism	`o:g@nIz@m
orgasm	`o:gAz@m
orgy	`o:dZi:
oriental	o:ri:`Entl
origin	`Or@dZ@n
original	@`rIdZ@n@l
originate	@`rIdZ@nEIt
ornament	`o:n@m@nt
orphan	`o:f@n
orthodontist	o:T@`dOnt@st
orthodox	`o:T@dOks
orthopaedic surgeon	o:T@;pi:dIk`s@:dZ@n
osteopath	`Osti:@pAT
other	`aD@
otherwise	`aD@wa:Iz
ought	o:t
our	a:U@
ours	`a:U@z
ourselves	a:U@`sElvz
out	a:Ut
outback	`a:UtbAk
outbreak	`a:UtbrEIk
outburst	`a:Utb@:st
outcome	`a:Utkam
outcry	`a:Utkra:I
outdoors	a:Ut`do:z
outer	`a:Ut@
outfit	`a:UtfIt
outgoing	a:Ut`g@UIN
outing	`a:UtIN
outline	`a:Utla:In
outlook	`a:UtlUk
outpatient	`a:UtpEIS@nt
outrage	a:Ut`rEIdZ
outright	`a:Utra:It
outset	`a:UtsEt
outside	a:Ut`sa:Id
outskirts	`a:Utsk@:ts
outspoken	`a:Utsp@Uk@n
outstanding	a:Ut`stAndIN
outward	`a:Utw@d
outwards	`a:Utw@dz
outwit	a:Ut`wIt
oval	`@Uv@l
ovary	`@Uv@ri:
oven	`av@n
over	`@Uv@
overalls	`@Uv@ro:lz
overarm	`@Uv@ra:m
overawe	@Uv@r`o:
overbalance	@Uv@`bAl@ns
overbearing	@Uv@`bE@rIN
overboard	`@Uv@bo:d
overcast	`@Uv@ka:st
overcoat	`@Uv@k@Ut
overcome	@Uv@`kam
overdo	@Uv@`du:
overdose	`@Uv@d@Us
overdraft	`@Uv@dra:ft
overdue	@Uv@`dju:
overflow	@Uv@`fl@U
overhaul	`@Uv@ho:l
overhead	@Uv@`hEd
overhear	@Uv@`hI@
overlap	@Uv@`lAp
overlook	@Uv@`lUk
overnight	@Uv@`na:It
overpower	@Uv@`pa:U@
overrule	@Uv@`ru:l
overseas	@Uv@`si:z
oversight	`@Uv@sa:It
overtake	@Uv@`tEIk
overtime	`@Uv@ta:Im
overturn	@Uv@`t@:n
overweight	@Uv@`wEIt
overwhelm	@Uv@`wElmd
overwork	@Uv@`w@:k
ovulate	`@vj@lEIt
owe	@U
owl	{Ol
own	@Un
oxygen	`Oks@dZ@n
oyster	`o:Ist@
p	pi:
p & c	`pi:@nsi:
p-plate	`pi:-plEIt
p.a.	p@:r`An@m
p.m.	pi:`Em
p.t.o.	pi:ti:`@U
pa	pi:`EI
pace	pEIs
pacifist	`pAs@f@st
pacify	`pAs@fa:I
pack	pAk
package	`pAkIdZ
packaging	`pAkIdZIN
packed	pAkt
packet	`pAk@t
pact	pAkt
pad	pAd
paddle	`pAdl
paddock	`pAd@k
padlock	`pAdlOk
paediatrician	pi:di:@`trISn
page	pEIdZ
paid	pEId
paid-up	`pEId-ap
pain	pEIn
painstaking	`pEInztEIkIN
paint	pEInt
painting	`pEIntIN
pair	pE@
pal	pAl
palace	`pAl@s
palate	rpAl@t
pale	pEIl
palm	pa:m
palpitate	`pAlp@tEIt
paltry	`po:ltri:
pamper	`pAmp@
pamphlet	`pAmfl@t
pan	pAn
pancake	`pANkEIk
pancreas	`pANkri:@s
pandemonium	pAnd@`m@Uni:@m
pander	`pAnd@
pane	pEIn
panel	`pAn@l
panel van	`pAn@lvAn
pang	pAN
panic	`pAnIk
panorama	pAn@`ra:m@
pant	pAnt
pantihose	`pAnti:h@Uz
pantomime	`pAnt@ma:Im
pantry	`pAntri:
pants	pAnts
pap smear	`pApsmI@
paper	p{Ip@
paperback	`pEIp@bAk
par	pa:
parachute	`pAr@Su:t
parade	p@`rEId
paradise	`pAr@da:Is
paradox	`pAr@dOks
paragraph	`pAr@grAf
parallel	`pAr@lEl
paralyse	`pAr@la:Iz
paramedic	pAr@`mEdIk
paramount	`pAr@ma:Unt
paranoia	pAr@`no:I@
paraphernalia	pAr@f@`nEIlj@
paraphrase	`pAr@frEIz
paraplegic	pAr@`pli:dZIk
parasite	`pAr@sa:It
parcel	`pa:s@l
pardon	`pa:dn
parent	`pE@r@nt
parish	`pArIS
park	pa:k
parka	`pa:k@
parliament	`pa:l@m@nt
parody	`pAr@di:
parole	p@`r@Ul
parquet	`pa:kEI
parrot	`pAr@t
parry	`pAri:
parsley	`pa:sli:
part	pa:t
part-time	pa:t-`ta:Im
partial	`pa:S@l
participate	p@`tIs@pEIt
participle	`pa:t@sIp@l
particle	`pa:tIk@l
particular	p@`tIkj@l@
partition	p@`tIS@n
partner	`pa:tn@
party	`pa:ti:
pass	pa:s
passage	`pAsIdZ
passenger	`pAs@ndZ@
passion	`pAS@n
passionfruit	`pAS@nfru:t
passive	`pAsIv
passport	`pa:spo:t
password	`pa:sw@:d
past	pa:st
pasta	`pAst@
paste	pEIst
pastel	`pAstl
pasteurise	`pa:stS@ra:Iz
pastime	`pa:s.ta:Im
pastry	`pEIstri:
pasture	`pa:stS@
pasty	`pEIsti:
pat	pAt
patch	pAtS
patent	`pEItnt
paternal	p@`t@:n@l
paternity	p@`t@:n@ti:
path	p6:T
pathetic	p@`TEtIk
pathology	p@`TOl@dZi:
patient	`pEIS@nt
patio	`pAti:@U
patriarch	`pEItri:a:k
patriot	`pEItri:@t
patrol	p@`tr@Ul
patron	`pEItr@n
patronise	`pAtr@na:Iz
patter	`pAt@
pattern	`pAtn
pause	po:z
pave	pEIv
pavement	`pEIvm@nt
pavilion	p@`vIlj@n
pavlova	pAv`l@Uv@
paw	po:
pawn	po:n
pay	pEI
paye	pi:EIwa:I`i:
payroll	`pEIr@Ul
pea	pi:
peace	pi:s
peach	pi:tS
peak	pi:k
peal	pi:l
pearl	p@:l
peasant	`pEz@nt
peat	pi:t
pebble	`pEb@l
peck	pEk
peckish	`pEkIS
peculiar	p@`kju:li:@
pedal	`pEdl
pedantic	p@`dAntIk
peddle	`pEdl
pedestal	`pEd@stl
pedestrian	p@`dEstri:@n
pee	pi:
peek	pi:k
peel	pi:l
peep	pi:p
peer	pI@
peeve	pi:v
peevish	`pi:vIS
peg	pEg
pelt	pElt
pelvis	`pElv@s
pen	pEn
penal	`pi:n@l
penalise	`pi:n@la:Iz
penalty	`pEn@lti:
pencil	`pEns@l
pendant	`pEnd@nt
penetrate	`pEn@trEIt
penfriend	`pEnfrEnd
penguin	`pENgw@n
penicillin	pEn@`sIl@n
peninsula	p@`nInS@l@
penis	`pi:n@s
penknife	`pEnna:If
penny	`pEni:
pension	`pEnS@n
pentathlon	pEn`tATl@n
penthouse	`pEntha:Us
people	`pi:p@l
pepper	`pEp@
peppermint	`pEp@m@nt
per	p@:
per cent	p@`sEnt
perceive	p@`si:v
perception	p@`sEpS@n
perch	p@:tS
percolate	`p@:k@lEIt
perfect	`p@:fEkt
perform	p@`fo:m
perfume	`p@:fju:m
pergola	p@`g@Ul@
perhaps	p@`hAps
peril	`pEr@l
period	`pI@ri:@d
periodical	pI@ri:`OdIk@l
peripheral	p@`rIf@r@l
perish	`pErIS
perishable	`pErIS@b@l
perjure	`p@:dZ@
perk	p@:k
permanent	`p@:m@n@nt
permission	p@`mIS@n
permit	p@`mIt
perpetrate	`p@:p@trEIt
perpetual	p@`pEtSu:@l
persecute	`p@:s@kju:t
persevere	p@:s@`vI@.
persian	`p@:Z@n
persist	p@`sIst
person	`p@:s@n
personal	`p@:s@n@l
personality	p@:s@`nAl@ti:
personify	p@`sOn@fa:I
personnel	p@:s@`nEl
perspire	p@`spa:I@
persuade	p@`swEId
pert	p@:t
pertinent	`p@:t@n@nt
perturb	p@`t@:b
perverse	p@`v@:s
pervert	`p@:v@:t
pessimism	`pEs@mIz@m
pest	pEst
pester	`pEst@
pet	pEt
petal	`pEtl
peter out	pi:t@`a:Ut
petite	p@`ti:t
petition	p@`tIS@n
petrify	`pEtr@fa:I
petrol	`pEtr@l
petroleum	p@`tr@Uli:@m
petticoat	`pEti:k@Ut
petty	`pEti:
petulant	`pEtS@l@nt
pewter	`pju:t@
phantom	`fAnt@m
pharmacist	`fa:m@s@st
phase	fEIz
phenomenal	f@`nOm@n@l
phenomenon	f@`nOm@n@n
phew	fju:
philosophy	f@`lOs@fi:
phlegm	flEm
phlegmatic	flEg`mAtIk
phobia	`f@Ubi:@
phone	f@Un
phonetics	f@`nEtIks
phoney	`f@Uni:
photo	`f@Ut@U
photocopy	`f@Ut@U`kOpi:
photogenic	f@Ut@`dZi:nIk
photograph	`f@Ut@grAf
phrase	frEIz
physical	`fIzIk@l
physician	f@`zIS@n
physics	`fIzIks
physiology	fIzi:`Ol@dZi:
physiotherapist	fIzi:@U`TEr@p@st
physique	f@`zi:k
piano	pi:`An@U
pick	pIk
picket	`pIk@t
pickle	`pIk@l
pickpocket	`pIkpOk@t
picnic	`pIknIk
pictorial	pIk`to:ri:@l
picture	`pIktS@
pidgin	`pIdZ@n
pie	pa:I
piece	pi:s
pier	pI@
pierce	pI@s
pig	pIg
pig-headed	pIg-`hEd@d
pigment	`pIgm@nt
pigsty	`pIgsta:I
pile	pa:Il
pile-up	`pa:Il-ap
pilfer	`pIlf@
pilgrim	`pIlgr@m
pilipino	pIl@`pi:n@U
pill	pIl
pillar	`pIl@
pillow	`pIl@U
pillowcase	`pIl@UkEIs
pilot	`pa:Il@t
pimple	`pImp@l
pin	pIn
pin-up	`pIn-ap
pinch	pIntS
pine	pa:In
ping-pong	`pINpON
pink	pINk
pioneer	pa:I@`nI@
pious	`pa:I@s
pip	pIp
pipe	pa:Ip
pirate	`pa:Ir@t
pistol	`pIstl
piston	`pIst@n
pit	pIt
pitch	pItS
pitch-dark	`pItS-da:k
pitfall	`pItfo:l
pith	pIT
pitiful	`pIt@f@l
pittance	`pItns
pity	`pIti:
pivot	`pIv@t
placate	pl@`kEIt
place	plEIs
placid	`plAs@d
plague	plEIg
plain	plEIn
plait	plAt
plan	plAn
plane	plEIn
planet	`plAn@t
plank	plANk
plant	plAnt
plaque	pla:k
plaster	`pla:st@
plastered	`pla:st@d
plastic	`plAstIk
plastic surgery	plAstIk`s@:dZ@ri:
plate	plEIt
plateau	`plAt@U
platform	`plAtfo:m
platter	`plAt@
platypus	`plAt@pUs
plausible	`plo:z@b@l
play	plEI
playground	`plEIgra:Und
playwright	`plEIra:It
plea	pli:
plead	pli:d
pleasant	`plEz@nt
please	pli:z
pleasure	`plEZ@
pleat	pli:t
pledge	plEdZ
plenty	`plEnti:
pliable	`pla:I@b@l
pliers	`pla:I@z
plight	pla:It
plod	plOd
plonk	plONk
plot	plOt
plough	pla:U
ploy	plo:I
pluck	plak
plucky	`plaki:
plug	plag
plughole	`plagh@Ul
plumber	`plam@
plummet	`plam@t
plump	plamp
plunge	plandZ
plural	`plU@r@l
plus	plas
plush	plaS
ply	pla:I
plywood	`pla:IwUd
pneumonia	nju:`m@Unj@
po	pi:`@U
poach	p@UtS
pocket	`pOk@t
pocket money	`pOk@tmani:
pod	pOd
podgy	`pOdZi:
poem	`p@U@m
poetry	`p@U@tri:
point	po:Int
point-blank	po:Int-`blANk
pointless	`po:Intl@s
poise	po:Iz
poison	`po:Iz@n
poke	p@Uk
poker	`p@Uk@
poky	`p@Uki:
pole	p@}l
police	p@`li:s
policy	`pOl@si:
polio	`p@Uli:@U
polish	`p@UlIS
polite	p@`la:It
politician	pOl@`tIS@n
politics	`pOl@tIks
poll	p@U
pollen	`pOl@n
pollute	p@`lu:t
polo	`p@Ul@U
pommy	`pOmi:
pompous	`pOmp@s
pond	pOnd
ponder	`pOnd@
pong	pON
pony	`p@Uni:
ponytail	`p@Uni:tEIl
poo	pu:
pooh	pu:
pool	pu:l
poor	po:
pop	pOp
pope	p@Up
popular	`pOpj@l@
populate	`pOpj@lEIt
porch	po:tS
pore	po:
pork	po:k
pornography	po:`nOgr@fi:
porous	`po:r@s
porridge	`pOrIdZ
port	po:t
portable	`po:t@bl
porter	`po:t@
portfolio	po:t`f@Uli:@U
portion	`po:S@n
portrait	`po:tr@t
portray	po:`trEI.
portuguese	po:tS@`gi:z
pose	p@Uz
posh	pOS
position	p@`zIS@n
positive	`pOz@tIv
possess	p@`zEs
possession	p@`zES@n
possessive	p@`zEsIv
possible	`pOs@b@l
possum	`pOs@m
post	p@Ust
post office	`p@UstOf@s
post-mortem	p@Ust-`mo:t@m
post-office box	`p@Ust-Of@sbOks
postal label	`p@UstllEIb@l
postbox	`p@UstbOks
postcard	`p@Ustka:d
postcode	`p@Ustk@Ud
poster	`p@Ust@
posterior	pO`stI@ri:@
posterity	pO`stEr@ti:
postgraduate	p@Ust`grAdZu:@t
postman	`p@Ustm@n
postpone	p@Ust`p@Un
postscript	`p@UstskrIpt
posture	`pOstS@
posy	`p@u:zi:
pot	pOt
potato	p@`tEIt@U
potent	`p@Utnt
potential	p@`tEnS@l
pothole	`pOth@Ul
potter	`pOt@
potty	`pOti:
pouch	pa:UtS
poultry	`p@Ultri:
pounce	pa:Uns
pound	pa:Und
pour	po:
pout	pa:Ut
poverty	`pOv@ti:
powder	`pa:Ud@
power	`pa:U@
practical	`prAktIk@l
practically	`prAktIkli:
practice	`prAkt@s
practise	`prAkt@s
praise	prEIz
pram	prAm
prance	prAns
prank	pra:Nk
prattle	`prAtl
prawn	pro:n
pray	prEI
preach	pri:tS
precarious	pr@`kE@ri:@s
precaution	pr@`ko:S@n
precede	pri:`si:d
precedent	`pri:s@d@nt
precious	`prES@s
precipice	`prEs@p@s
precis	`prEIsi:
precise	pr@`sa:Is
precocious	prE`k@US@s
predecessor	`pri:d@sEs@
predicament	pr@`dIk@m@nt
predict	pr@`dIkt
predictable	pr@`dIkt@b@l
predominant	pr@`dOm@n@nt
preen	pri:n
preface	`prEf@s
prefect	`pri:fEkt
prefer	pr@`f@:
prefix	`pri:fIks
pregnant	`prEgn@nt
prejudice	`prEdZ@d@s
preliminary	pr@`lIm@nri:
prelude	`prElju:d
premature	`prEm@tS@
premier	`prEmi:@
premiere	prEmi:`E@
premise	`prEm@s
premium	`pri:mi:@m
premonition	`prEm@nIS@n
preoccupied	pri:`Okj@pa:Id
prepare	pr@`pE@
preposition	prEp@`zIS@n
preposterous	pr@`pOstr@s
prescribe	pr@`skra:Ib
prescription	pr@`skrIpS@n
present	`prEz@nt
presentable	pr@`zEnt@b@l
presently	`prEz@ntli:
preserve	pr@`z@:v
president	`prEz@d@nt
press	prEs
press-up	`prEs-ap
pressure	`prES@
prestige	prEs`ti:Z
presume	pr@`zju:m
pretend	pr@`tEnd
pretty	`prIti:
prevalent	`prEv@l@nt
prevaricate	pr@`vAr@kEIt
prevent	pr@`vEnt
preview	`pri:vju:
previous	`pri:vi:@s
prey	prEI
price	pra:Is
priceless	`pra:Isl@s
pricey	`pra:Isi:
prick	prIk
pride	pra:Id
priest	pri:st
prig	prIg
prim	prIm
primary	`pra:Im@ri:
primary school	`pra:Imri:sku:l
prime	pra:Im
prime minister	pra:Im`mIn@st@
prime number	pra:Im`namb@
primitive	`prIm@tIv
prince	prIns
princess	`prInsEs
principal	`prIns@p@l
principle	`prIns@p@l
print	prInt
printer	`prInt@
prior	`pra:I@
priority	pra:I`Or@ti:
prise	pra:Iz
prism	`prIzm
prison	`prIz@n
private	`pra:Iv@t
privilege	`prIv@lIdZ
prize	pra:Iz
pro rata	pr@U`ra:t@
probable	`prOb@b@l
probe	pr@Ub
problem	`prObl@m
procedure	pr@`si:dZ@
proceed	pr@`si:d
process	`pr@UsEs
prod	prOd
prodigy	`prOd@dZi:
produce	pr@`dju:s
product	`prOdakt
productive	pr@`daktIv
profession	pr@`fES@n
professor	pr@`fEs@
proficient	pr@`fIS@nt
profile	`pr@Ufa:Il
profit	`prOf@t
profound	pr@`fa:Und
program	`pr@UgrAm
programme	`pr@UgrAm
progress	`pr@UgrEs
progressive	pr@`grEsIv
prohibit	pr@`hIb@t
project	`pr@UdZEkt
prologue	`pr@UlOg
prolong	pr@`lON
promenade	prOm@`na:d
prominent	`prOm@n@nt
promise	`prOm@s
promote	pr@`m@Ut
prompt	prOmpt
prone	pr@Un
prong	prON
pronoun	`pr@Una:Un
pronounce	pr@`na:Uns
pronounced	pr@`na:Unst
proof	pru:f
prop	prOp
propaganda	prOp@`gAnd@
propel	pr@`pEl
proper	`prOp@
property	`prOp@ti:
proportion	pr@`po:S@n
propose	pr@`p@Uz
proprietary limited company	pr@`pra:I@tri:lIm@t@d`kamp@ni:
proprietor	pr@`pra:I@t@
prose	pr@Uz
prosecute	`prOs@kju:t
prospect	`prOspEkt
prospectus	pr@`spEkt@s
prosper	`prOsp@
prostitute	`prOst@tju:t
protect	pr@`tEkt
protective	pr@`tEktIv
protein	`pr@Uti:n
protest	pr@`tEst
protestant	`prOt@st@nt
protocol	`pr@Ut@kOl
prototype	`pr@Ut@ta:Ip
protracted	pr@`trAkt@d
proud	pra:Ud
prove	pru:v
provide	pr@`va:Id
provision	pr@`vIZ@n
provisional	pr@`vIZ@n@l
provoke	pr@`v@Uk
prowl	pra:Ul
proxy	`prOksi:
prudent	`pru:d@nt
prune	pru:n
pry	pra:I
ps	pi:`Es
pseudonym	`sju:d@nIm
psych	sa:Ik
psyche	`sa:Iki:
psychiatrist	s@`ka:I@tr@st
psychic	`sa:IkIk
psycho	`sa:Ik@U
psychoanalyst	sa:Ik@U`An@l@st
psychology	sa:I`kOl@dZi:
pub	pab
puberty	`pju:b@ti:
pubic	`pju:bIk
public	`pablIk
public relations	pablIkr@`lEISnz
public school	pablIk`sku:l
public servant	pablIk`s@:v@nt
public service	pablIk`s@:v@s
publican	`pablIk@n
publication	pabl@`kEIS@n
publicity	pab`lIs@ti:
publish	`pablIS
pucker	`pak@
pudding	`pUdIN
puddle	`padl
puff	paf
pugnacious	pag`nEIS@s
pull	pUl
pullover	`pUl@Uv@
pulp	palp
pulse	pals
pump	pamp
pumpkin	`pampk@n
pun	pan
punch	pantS
punctual	`paNktSu:@l
punctuation	paNktSu:`EIS@n
puncture	`paNktS@
punish	`panIS
punt	pant
puny	`pju:ni:
pup	pap
pupil	`pju:p@l
puppet	`pap@t
purchase	`p@:tS@s
pure	`pju:@
puree	`pju:rEI
purge	p@:dZ
purple	p3:p@l
purpose	`p@:p@s
purr	p@:
purse	p@:s
pursue	p@`sju:
pus	pas
push	pUS
push-up	`pUS-ap
pushed	pUSt
pusher	`pUS@
pushover	`pUS@Uv@
put	pUt
putty	`pati:
puzzle	`paz@l
pyjamas	p@`dZa:m@z
pylon	`pa:IlOn
pyramid	`pIr@mId
python	`pa:IT@n
q	kju:
qc	kju:`si:
qld	`kwi:nzl@nd
quack	kwAk
quadrangle	`kwOdrANg@l
quadriplegic	kwOdr@`pli:dZIk
quadruped	`kwOdr@pEd
quadruple	kw@`dru:p@l
quadruplet	kwO`dru:pl@t
quaint	kwEInt
quake	kwEIk
qualify	`kwOl@fa:I
quality	`kwOl@ti:
quantity	`kwOnt@ti:
quarantine	`kwOr@nti:n
quarrel	`kwOr@l
quarry	`kwOri:
quarter	`kwo:t@
quartet	kwo:`tEt
quay	ki:
queen	kwi:n
queer	`kwI@
query	`kwI@ri:
quest	kwEst
question	`kwEstS@n
questionnaire	kwEstS@n`E@
queue	kju:
quibble	`kwIb@l
quiche	ki:S
quick	kwIk
quicksand	`kwIksAnd
quiet	`kwa:I@t
quilt	kwIlt
quinine	`kwIni:n
quip	kwIp
quit	kwIt
quite	kwa:It
quiz	kwIz
quorum	`kwo:r@m
quota	`kw@Ut@
quotation	kw@U`tEIS@n
quotation marks	kw@U`tEIS@nma:ks
quote	kw@Ut
r	a:
rabbi	`rAba:I
rabble	`rAb@l
race	rEIs
racecourse	`rEIsko:s
racist	`rEIs@st
rack	rAk
racket	`rAk@t
racquet	`rAk@t
radar	`rEIda:
radiation	rEIdi:`EIS@n
radiator	`rEIdi:EIt@
radical	`rAdIk@l
radio	`rEIdi:@U
radioactive	rEIdi:@U`AktIv
radiography	rEIdi:`Ogr@fi:
radiologist	rEIdi:`Ol@dZ@st
radiotherapy	rEIdi:@U`TEr@pi:
radish	`rAdIS
radius	`rEIdi:@s
raffle	`rAf@l
rafter	`ra:ft@
rag	rAg
rage	rEIdZ
ragged	`rAg@d
raid	rEId
rail	rEIl
railing	`rEIlIN
railway	r\{Ilw{I
rain	rEIn
rainbow	`rEInb@U
rainforest	`rEInfOr@st
raise	rEIz
raisin	`rEIz@n
rake	rEIk
rally	`rAli:
ram	rAm
ramble	`rAmb@l
ramp	rAmp
ramshackle	`rAmSAk@l
ran	rAn
random	`rAnd@m
rang	rAN
range	rEIndZ
ranger	`rEIndZ@
rank	rANk
ransack	`rAnsAk
ransom	`rAns@m
rape	rEIp
rapid	`rAp@d
rare	rE@
rash	rAS
rasher	`rAS@
rat	rAt
rate	rEIt
rather	`ra:D@
ratio	`rEISi:@U
ration	`rAS@n
ratshit	`rAtSIt
rattle	`rAtl
rave	rEIv
ravenous	`rAv@n@s
ravine	r@`vi:n
ravishing	`rAv@SIN
raw	ro:
ray	rEI
razor	`rEIz@
re	ri:
re-count	`ri:-ka:Unt
reach	ri:tS
react	ri:`Akt
read	ri:d
ready	`rEdi:
real	ri:l
real estate	`ri:l@stEIt
realise	`ri:@la:Iz
realist	`ri:@l@st
reality	ri:`Al@ti:
really	`rI@li:
realty	`ri:@lti:
rear	`rI@
reason	`ri:z@n
reasonable	`ri:z@n@b@l
rebate	`ri:bEIt
rebel	`rEb@l
recall	`r@ko:l
recede	r@`si:d
receipt	r@`si:t
receive	r@`si:v
receiver	r@`si:v@
recent	`ri:s@nt
receptacle	r@`sEpt@k@l
reception	r@`sEpS@n
receptionist	r@`sEpS@n@st
recess	r@`sEs
recession	r@`sES@n
recipe	`rEs@pi:
recipient	r@`sIpi:@nt
recital	r@`sa:It@l
recite	r@`sa:It
reckless	`rEkl@s
reckon	`rEk@n
recognise	`rEk@gna:Iz
recoil	r@`ko:Il
recollect	rEk@`lEkt
recommend	rEk@`mEnd
reconcile	`rEk@nsa:Il
record	r@`ko:d
record-player	`rEko:d-plEI@
recorder	r@`ko:d@
recount	r@`ka:Unt
recover	r@`kav@
recreation	rEkri:`EIS@n
recruit	r@`kru:t
rectangle	`rEktANg@l
rectum	`rEkt@m
recuperate	r@`ku:p@rEIt
recur	r@`k@:
recycle	ri:`sa:Ik@l
red	r\ed
red tape	rEd`tEIp
red-back	`rEd-bAk
redeem	r@`di:m
reduce	r@`dju:s
redundant	r@`dand@nt
reef	ri:f
reel	ri:l
refer	r@`f@:
referee	rEf@`ri:
reference	`rEfr@ns
referendum	rEf@`rEnd@m
reflect	r@`flEkt
reflex	`ri:flEks
reflexive pronoun	r@flEksIv`pr@Una:Un
reform	r@`fo:m
refrain	r@`frEIn
refresh	r@`frES
refreshments	r@`frESm@nts
refrigerator	r@`frIdZ@rEIt@
refuge	`rEfju:dZ
refugee	rEfju:`dZi:
refund	`ri:fand
refuse	r@`fju:z
regain	r@`gEIn
regard	r@`ga:d
regardless	r@`ga:dl@s
regime	rEI`Zi:m
region	`ri:dZ@n
register	`rEdZ@st@
registry	`rEdZ@stri:
registry office	`rEdZ@stri:Of@s
rego	`rEdZ@U
regret	r@`grEt
regular	`rEgj@l@
regulate	`rEgj@lEIt
regulation	rEgj@`lEIS@n
rehabilitate	ri:h@`bIl@tEIt
rehearse	r@`h@:s
reign	rEIn
reimburse	ri:Im`b@:s
rein	rEIn
reincarnation	ri:Inka:`nEIS@n
reinforce	ri:In`fo:s
reinforcements	ri:In`fo:sm@nts
reinstate	ri:In`stEIt
reject	r@`dZEkt
rejoice	r@`dZo:Is
relapse	r@`lAps
relate	r@`lEIt
relation	r@`lEIS@n
relationship	r@`lEIS@nSIp
relative	`rEl@tIv
relative pronoun	rEl@tIv`pr@Una:Un
relatively	`rEl@tIvli:
relax	r@`lAks
relay	`ri:lEI
release	r@`lIs
relent	r@`lEnt
relentless	r@`lEntl@s
relevant	`rEl@v@nt
reliable	r@`la:I@b@l
reliant	r@`la:I@nt
relic	`rElIk
relief	r@`li:f
relieve	r@`li:v
religion	r@`lIdZ@n
reluctant	r@`lakt@nt
rely	r@`la:I
remain	r@`mEIn
remainder	r@`mEInd@
remark	r@`ma:k
remarkable	r@`ma:k@b@l
remarry	ri:`mAri:
remedy	`rEm@di:
remember	r@`mEmb@
remind	r@`ma:Ind
remittance	r@`mIt@ns
remnant	`rEmn@nt
remote	r@`m@Ut
removalist	r@`mu:v@l@st
remove	r@`mu:v
renal	`ri:n@l
renew	r@`nju:
renounce	r@`na:Uns
renovate	`rEn@vEIt
rent	rEnt
rental	`rEnt@l
repair	r@`pE@
repay	ri:`pEI
repayment	r@`pEIm@nt
repeat	r@`pi:t
repeated	r@`pi:t@d
repel	r@`pEl
repellent	r@`pEl@nt
repent	r@`pEnt
replace	r@`plEIs
replay	`ri:plEI
replica	`rEplIk@
reply	r@`pla:I
report	r@`po:t
reporter	r@`po:t@
repossess	ri:p@`zEs
represent	rEpr@`zEnt
representative	rEpr@`zEnt@tIv
reprieve	r@`pri:v
reprimand	`rEpr@ma:nd
reprint	ri:`prInt
reproach	r@`pr@UtS
reproduce	ri:pr@`dju:s
reptile	`rEpta:Il
republic	r@`pablIk
repugnant	r@`pagn@nt
repulsive	r@`palsIv
reputable	`rEpj@t@b@l
reputation	rEpj@`tEIS@n
reputed	r@`pju:t@d
request	r@`kwEst
require	r@`kwa:I@
rescue	`rEskju:
research	r@`s@:tS
resemble	r@`zEmbl
resent	r@`zEnt
reservation	rEz@`vEISn
reserve	r@`z@:v
reserve price	r@`z@:vpra:Is
reserved	r@`z@:vd
reservoir	`rEz@vwa:
residence	`rEz@d@ns
resident	`rEz@d@nt
residential	rEz@`dEnSl
residue	`rEz@dju:
resign	r@`za:In
resist	r@`zIst
resistant	r@`zIst@nt
resolute	`rEz@lu:t
resolution	rEz@`lu:Sn
resolve	r@`zOlv
resort	r@`zo:t
resource	r@`zo:s
resourceful	r@`zo:sfUl
respect	r@`spEkt
respectable	r@`spEkt@bl
respectively	r@`spEktIvli:
respiration	rEsp@`rEISn
respond	r@`spOnd
responsible	r@`spOns@b@l
rest	rEst
restaurant	`rEst@rOnt
restless	`rEstl@s
restore	r@`sto:
restrain	r@`strEIn
restrained	r@`strEInd
restrict	r@`strIkt
result	r@`zalt
resum;aae	`rEZju:mEI
resume	r@`zju:m
resurrect	rEz@`rEkt
resuscitate	r@`sas@tEIt
retail	`ri:tEIl
retain	r@`tEIn
retaliate	r@`tAli:EIt
retire	r@`ta:I@
retrace	ri:`trEIs
retreat	r@`tri:t
retrench	r@`trEntS
retrieve	r@`tri:v
retrospective	rEtr@`spEktIv
return	r@`t@:n
reunion	ri:`ju:nj@n
reveal	r@`vi:l
revel	`rEv@l
revenge	r@`vEndZ
revenue	`rEv@nju:
reverend	`rEvr@nd
reverent	`rEvr@nt
reverse	r@`v@:s
revert	r@`v@:t
review	r@`vju:
revise	r@`va:Iz
revive	r@`va:Iv
revolt	r@`v@Ult
revolution	rEv@`lu:Sn
revolutionary	rEv@`lu:S@nri:
revolve	r@`vOlv
revolver	r@`vOlv@
reward	r@`wo:d
rewarding	r@`wo:dIN
rheumatism	`ru:m@tIz@m
rhyme	ra:Im
rhythm	`rID@m
rib	rIb
ribbon	`rIb@n
rice	ra:Is
rich	rItS
rid	rId
riddle	`rIdl
ride	ra:Id
ridge	rIdZ
ridicule	`rId@kju:l
ridiculous	r@`dIkj@l@s
rifle	`ra:If@l
rift	rIft
rig	rIg
right	ra:It
rightful	`ra:Itf@l
rigid	`rIdZ@d
rim	rIm
rind	ra:Ind
ring	rIN
ring-in	`rIN-In
ringworm	`rINw@:m
rinse	rIns
riot	`ra:I@t
rip	rIp
ripcord	`rIpko:d
ripe	ra:Ip
ripple	`rIp@l
rise	ra:Iz
risk	rIsk
rival	`ra:Iv@l
river	`rIv@
road	r\@}d
roadway	`r@UdwEI
roadworks	`r@Udw@:ks
roam	r@Um
roar	ro:
roast	r@Ust
rob	rOb
robbery	`rOb@ri:
robe	r@Ub
robot	`r@UbOt
robust	`r@Ubast
rock	rOk
rockery	`rOk@ri:
rocket	`rOk@t
rod	rOd
rode	r@Ud
rogue	r@Ug
role	r@Ul
roll	r@Ul
roller-skate	`r@Ul@-skEIt
rom	rOm
roman	`r@Um@n
romance	r@`mAns
romanian	r@U`mEIni:@n
romp	rOmp
roof	ru:f
room	ru:m
rooms	r\}:mz
rooster	`ru:st@
root	ru:t
rope	r@Up
ropeable	`r@Up@bl
rort	ro:t
rose	r@Uz
roster	`rOst@
rosy	`r@Uzi:
rot	rOt
rotate	r@U`tEIt
rotten	`rOt@n
rough	raf
roughage	`rafIdZ
roulette	ru:`lEt
round	ra:Und
roundabout	`ra:Und@ba:Ut
rouse	ra:Uz
route	ru:t
routine	ru:`ti:n
row	r@U
rowdy	`ra:Udi:
royal	`ro:I@l
royalty	`ro:I@lti:
rsl	a:rEs`El
rsvp	a:rEsvi:`pi:
rub	rab
rubber	`rab@
rubbish	`rabIS
rubble	`rab@l
rubella	ru:`bEl@
ruby	`ru:bi:
rucksack	`raksAk
rudder	`rad@
ruddy	`radi:
rude	ru:d
ruffian	`rafi:@n
rug	rag
rugby	`ragbi:
rugged	`rag@d
ruin	`ru:@n
rule	ru:l
ruler	`ru:l@
rum	ram
rumble	`ramb@l
rummage	`ramIdZ
rumour	`ru:m@
rump	ramp
rumple	`ramp@l
rumpus	`ramp@s
run	ran
run-down	ran-`da:Un
rung	raN
runner-up	ran@r-`ap
runny	`rani:
runt	rant
runway	`ranwEI
rupture	`raptS@
rural	`rU@r@l
rush	raS
rust	rast
rut	rat
ruthless	`ru:Tl@s
s	Es
sa	sa:UT@`strEIlj@
sabbath	`sAb@T
sabin vaccine	`sEIb@nvAksi:n
sabotage	`sAb@ta:Z
saccharin	`sAk@r@n
sachet	`sASEI
sack	sAk
sacrament	`sAkr@m@nt
sacred	`sEIkr@d
sacrifice	`sAkr@fa:Is
sacrilege	`sAkr@lIdZ
sad	sAd
saddle	`sAdl
safari	s@`fa:ri:
safe	sEIf
sag	sAg
saga	`sa:g@
sage	sEIdZ
said	sEd
sail	sEIl
sailor	`sEIl@
saint	sEInt
sake	sEIk
salad	`sAl@d
salami	s@`la:mi:
salary	`sAl@ri:
sale	sEIl
sales tax	`sEIlztAks
salesperson	`sEIlzp@:sn
saline	`sEIla:In
saliva	s@`la:Iv@
sallow	`sAl@U
salon	`sAlOn
saloon	s@`lu:n
salt	sOlt
salute	s@`lu:t
salvage	`sAlvIdZ
salvation	sAl`vEIS@n
same	sEIm
sample	`sAmp@l
sanatorium	sAn@`to:ri:@m
sanction	`sANkS@n
sand	sAnd
sandal	`sAndl
sandpaper	`sAndpEIp@
sandwich	`sAnwItS
sandy	s{ndi:
sane	sEIn
sang	sAN
sanitary	sAn@tri:
sank	sANk
sap	sAp
sapphire	`sAfa:I@
sarcasm	`sa:kAz@m
sardine	sa:`di:n
sari	`sa:ri:
sarong	s@`rON
sash	sAS
sat	sAt
satchel	`sAtS@l
satellite	`sAt@la:It
satin	`sAtn
satire	`sAta:I@
satisfactory	sAt@s`fAktri:
satisfy	`sAt@sfa:I
saturate	`sAtS@rEIt
saturday	`sAt@dEI
sauce	so:s
saucepan	`so:sp@n
saucer	`so:s@
sauna	`so:n@
saunter	`so:nt@
sausage	`sOsIdZ
saute	`s@UtEI
savage	`sAvIdZ
save	sEIv
saviour	`sEIvj@
savour	`sEIv@
savoury	`sEIv@ri:
saw	so:
say	sEI
scab	skAb
scaffold	`skAf@Uld
scaffolding	`skAf@ldIN
scald	sko:ld
scale	skEIl
scallop	`skOl@p
scalp	skAlp
scalpel	`skAlp@l
scam	skAm
scamp	skAmp
scamper	`skAmp@
scan	skAn
scandal	`skAndl
scandinavian	skAnd@`nEIvi:@n
scant	skAnt
scapegoat	`skEIpg@Ut
scar	ska:
scarce	skE@s
scarcely	`skE@sli:
scare	skE@
scarecrow	`skE@kr@U
scared	skE@d
scarf	ska:f
scarlet	`ska:l@t
scarlet fever	ska:l@t`fi:v@
scary	`skE@ri:
scathing	`skEIDIN
scatter	`skAt@
scatterbrain	`skAt@brEIn
scatty	`skAti:
scavenge	`skAv@ndZ
scene	si:n
scenery	`si:n@ri:
scent	sEnt
sceptical	`skEptIk@l
schedule	`SEdZu:l
scheme	ski:m
scholar	`skOl@
scholarship	`skOl@SIp
school	sk}:l
schooner	`sku:n@
science	`sa:I@ns
scientist	`sa:I@nt@st
scissors	`sIz@z
scoff	skOf
scold	sk@Uld
scone	skOn
scoop	sku:p
scooter	`sku:t@
scope	sk@Up
scorch	sko:tS
score	sko:
scorn	sko:n
scot-free	skOt-`fri:
scotch	skOtS
scottish	`skOtIS
scoundrel	`ska:Undr@l
scout	sk{Ot
scowl	ska:Ul
scrabble	`skrAbl
scraggy	`skrAgi:
scramble	`skrAmb@l
scrap	skrAp
scrape	skrEIp
scratch	skrAtS
scrawl	skro:l
scream	skri:m
screech	skri:tS
screen	skri:n
screw	skru:
screwdriver	`skru:dra:Iv@
scribble	`skrIb@l
scrimp	skrImp
script	skrIpt
scripture	`skrIptS@
scroll	skr@Ul
scrotum	`skr@Ut@m
scrounge	skra:UndZ
scrub	skrab
scruff	skraf
scruffy	`skrafi:
scrum	skram
scrupulous	`skru:pj@l@s
scrutinise	`skru:t@na:Iz
scuba diving	`sku:b@da:IvIN
scuff	skaf
scuffle	`skaf@l
scullery	`skal@ri:
sculpture	`skalptS@
scum	skam
scurry	`skari:
scuttle	`skatl
sea	si:
seafood	`si:fu:d
seagull	si:g6l
seal	si:l
seam	si:m
seance	`sEIOns
search	s@:tS
seashore	`si:So:
seasickness	`si:sIkn@s
seaside	`si:sa:Id
season	`si:z@n
seasonal	`si:z@n@l
seat	si:t
sec	sEk
secateurs	`sEk@t@z
second	`sEk@nd
second-class	`sEk@nd-kla:s
second-hand	sEk@nd-`hAnd
second-rate	`sEk@nd-rEIt
secondary	`sEk@ndri:
secret	`si:kr@t
secretary	`sEkr@tri:
secrete	s@`kri:t
sect	sEkt
section	`sEkS@n
sector	`sEkt@
secular	`sEkj@l@
secure	s@`kju:@
security	s@`kju:r@ti:
sedan	s@`dAn
sedate	s@`dEIt
sedative	`sEd@tIv
sediment	`sEd@m@nt
seduce	s@`dju:s
see	si:
seed	si:d
seedling	`si:dlIN
seedy	`si:di:
seek	si:k
seem	si:m
seep	si:p
seesaw	`si:so:
segment	`sEgm@nt
segregate	`sEgr@gEIt
seize	si:z
seldom	`sEld@m
select	s@`lEkt
selective	s@`lEktIv
self	sElf
self-centred	sElf-`sEnt@d
self-confident	sElf-`kOnf@d@ns
self-conscious	sElf-`kOnS@s
self-defence	sElf-d@`fEns
self-service	sElf-`s@:v@s
selfish	`sElfIS
sell	sEl
semen	`si:m@n
semester	s@`mEst@
semi-conscious	sEmi:-`kOnS@s
semi-detached	sEmi:d@`tAtSt
semicolon	sEmi:`k@Ul@n
seminar	`sEm@na:
seminary	`sEm@nri:
semitrailer	sEmi:`trEIl@
senate	`sEn@t
senator	`sEn@t@
send	sEnd
senile	`sEna:Il
senior	`si:nj@
sensation	sEn`sEIS@n
sensational	sEn`sEIS@n@l
sense	sEns
sensible	`sEns@b@l
sensitive	`sEns@tIv
sent	sEnt
sentence	`sEnt@ns
sentiment	`sEnt@m@nt
sentimental	sEnt@`mEntl
sentry	`sEntri:
separate	`sEpr@t
sept.	s@p`tEmb@
september	s@p`tEmb@
septic	`sEptIk
septic tank	sEptIk`tANk
sequel	`si:kw@l
sequence	`si:kw@ns
serbian	`s@:bi:@n
serene	s@`ri:n
sergeant	`sa:dZ@nt
serial	`sI@ri:@l
series	`sI@ri:z
serious	`sI@ri:@s
sermon	`s@:m@n
serpent	`s@:p@nt
serrated	s@`rEIt@d
serum	`sI@r@m
servant	`s@:v@nt
serve	s@:v
service	`s@:v@s
service station	`s@:v@sstEIS@n
serviceable	`s@:v@s@b@l
serviette	s@:vi:`Et
serving	`s@:vIN
serving spoon	`s@:vINspu:n
session	`sES@n
set	sEt
set-up	`sEt-ap
setback	`sEtbAk
settee	sE`ti:
setting	`sEtIN
settle	`sEtl
seven	`sEv@n
seventeen	sEv@n`ti:n
seventeenth	sEv@n`ti:nT
seventh	`sEv@nT
seventies	`sEv@nti:z
seventy	`sEv@nti:
sever	`sEv@
several	`sEvr@l
severance pay	`sEvr@nspEI
severe	s@`vI@
sew	s@U
sewage	`su:IdZ
sewer	`su:@
sewerage	`su:@rIdZ
sewing machine	`s@UINm@Si:n
sex	sEks
sexism	`sEksIz@m
sexy	`sEksi:
shabby	`SAbi:
shack	SAk
shade	SEId
shadow	`SAd@U
shaggy	`SAgi:
shake	SEIk
shake-up	`SEIkap
shall	SAl
shallow	`SAl@U
sham	SAm
shame	SEIm
shampoo	SAm`pu:
shandy	`SAndi:
shant	Sa:nt
shanty	`SAnti:
shape	SEIp
share	SE@
shareholder	`SE@h@Uld@
shark	Sa:k
sharp	Sa:p
sharpener	`Sa:pn@
shatter	`SAt@
shave	SEIv
shaw	So:
shawl	So:l
shear	SI@
shed	SEd
sheep	Si:p
sheepish	`Si:pIS
sheer	SI@
sheet	Si:t
shelf	SElf
shell	SEl
shellfish	`SElfIS
shelter	`SElt@
shelve	SElv
shelving	`SElvIN
shield	Si:ld
shift	SIft
shifty	`SIfti:
shimmer	`SIm@
shin	SIn
shine	Sa:In
shingle	`SINg@l
ship	SIp
shipment	`SIpm@nt
shipshape	`SIpSEIp
shirk	S@:k
shirt	S@:t
shish kebab	`SISk@bAb
shit	SIt
shiver	`SIv@
shock	SOk
shoddy	`SOdi:
shoe	S}:
shone	SOn
shook	SUk
shoot	Su:t
shop	SOp
shop assistant	`SOp@sIst@nt
shop steward	SOp`stju:@d
shopkeeper	`SOpki:p@
shoplift	`SOplIft
shore	So:
shorn	So:n
short	So:t
short-sighted	So:t-`sa:It@d
short-tempered	So:t-`tEmp@d
shortage	`So:tIdZ
shortcoming	`So:tkamIN
shortcut	So:tk6t
shorten	`So:t@n
shorthand	`So:thAnd
shortly	`So:tli:
shot	SOt
shotgun	`SOtgan
should	SUd
shoulder	`S@Uld@
shout	Sa:Ut
shove	Sav
shovel	`Sav@l
show	S@U
show-off	`S@U-Of
showdown	`S@Uda:Un
shower	`Sa:U@
showy	`S@Ui:
shred	SrEd
shrewd	Sru:d
shriek	Sri:k
shrill	SrIl
shrimp	SrImp
shrink	SrINk
shrivel	`SrIv@l
shrub	Srab
shrug	Srag
shudder	`Sad@
shuffle	`Saf@l
shun	San
shut	Sat
shutter	`Sat@
shy	Sa:I
sibling	`sIblIN
sick	sIk
sicken	`sIk@n
sickening	`sIk@nIN
sickie	`sIki:
sickly	`sIkli:
sickness	`sIkn@s
side	sa:Id
side-effects	`sa:Id-@fEkts
sideshow	`sa:IdS@U
sideways	`sa:IdwEIz
siege	si:dZ
siesta	si:`Est@
sieve	sIv
sift	si:ft
sigh	sa:I
sight	sa:It
sightseeing	`sa:Itsi:IN
sign	sa:In
signal	`sIgn@l
signature	`sIgn@tS@
significant	sIg`nIf@k@nt
silence	`sa:Il@ns
silk	sIlk
silkworm	`sIlkw@:m
sill	sIl
silly	`sIli:
silver	`sIlv@
similar	`sIm@l@
simmer	`sIm@
simple	`sImp@l
simple-minded	`sImp@l-ma:Ind@d
simply	`sImpli:
simultaneous	sIm@l`tEIni:@s
sin	sIn
since	sIns
sincere	sIn`sI@
sincerely	sIn`sI@li:
sing	sIN
singe	sIndZ
single	`sINg@l
single-handed	sINg@l-`hAnd@d
single-minded	sINg@l-`ma:Ind@d
singlet	`sINl@t
singsong	`sINsON
singular	`sINgj@l@
sinister	`sIn@st@
sink	sINk
sinker	`sINk@
sinus	`sa:In@s
sinusitis	sa:In@`sa:It@s
sip	sIp
sir	s@:
siren	`sa:Ir@n
sissy	`sIsi:
sister	`sIst@
sister-in-law	`sIst@r-In-lo:
sit	sIt
sit-in	`sIt-In
sitcom	`sItkOm
site	sa:It
sitter	`sIt@
sitting room	`sItINru:m
situated	`sItSu:EIt@d
situation	sItSu:`EIS@n
six	sIks
sixteen	sIks`ti:n
sixteenth	sIks`ti:nT
sixth	sIksT
sixty	`sIksti:
size	sa:Iz
sizeable	`sa:Iz@b@l
sizzle	`sIz@l
skate	skEIt
skein	skEIn
skeleton	`skEl@tn
sketch	skEtS
sketchy	`skEtSi:
skewer	`skju:@
ski	ski:
skid	skId
skilful	`skIlf@l
skill	skIl
skim	skIm
skimp	skImp
skimpy	`skImpi:
skin	skIn
skinny	`skIni:
skip	skIp
skirt	sk@:t
skivvy	`skIvi:
skull	skal
sky	ska:I
skyscraper	`ska:IskrEIp@
slab	slAb
slack	slAk
slacken	`slAk@n
slam	slAm
slammer	`slAm@
slander	`slAnd@
slang	slAN
slant	slAnt
slap	slAp
slapdash	`slApdAS
slapstick	`slApstIk
slash	slAS
slat	slAt
slate	slEIt
slaughter	`slo:t@
slave	slEIv
slay	slEI
sleazy	`sli:zi:
sledge	slEdZ
sledgehammer	`slEdZhAm@
sleek	sli:k
sleep	sli:p
sleeve	sli:v
slender	`slEnd@
slice	sla:Is
slick	slIk
slide	sla:Id
slight	sla:It
slim	slIm
slime	sla:Im
sling	slIN
slink	slINk
slinky	`slINki:
slip	slIp
slippers	`slIp@z
slippery	`slIp@ri:
slippery dip	`slIpri:dIp
slit	slIt
slob	slOb
slobber	`slOb@
slog	slOg
slogan	`sl@Ug@n
slop	slOp
slope	sl@Up
sloppy	`slOpi:
sloppy joe	slOpi:`dZ@U
slosh	slOS
sloshed	slOSt
slot	slOt
slouch	sla:UtS
slovenly	`slav@nli:
slow	sl@U
sludge	sladZ
slug	slag
sluggish	`slagIS
slum	slam
slump	slamp
slung	slaN
slur	sl@:
slurp	sl@:p
slush	slaS
slut	slat
sly	sla:I
smack	smAk
small	smo:l
smallgoods	`smo:lgUdz
smallpox	`smo:lpOks
smart	sma:t
smash	smAS
smear	smI@
smell	smEl
smelt	smElt
smelter	`smElt@
smile	sma:Il
smirk	sm@:k
smithereens	smID@`ri:nz
smog	smOg
smoke	sm@Uk
smokescreen	`sm@Ukskri:n
smooth	smu:D
smorgasbord	`smo:g@zbo:d
smother	`smaD@
smoulder	`sm@Uld@
smudge	smadZ
smug	smag
smuggle	`smag@l
snack	snAk
snag	snAg
snail	snEIl
snake	snEIk
snap	snAp
snappy	`snApi:
snapshot	`snApSOt
snarl	sna:l
snatch	snAtS
sneak	sni:k
sneer	snI@
sneeze	sni:z
sniff	snIf
sniffle	`snIf@l
snigger	`snIg@
snip	snIp
snipe	sna:Ip
snivel	`snIv@l
snob	snOb
snooker	`snu:k@
snoop	snu:p
snooty	`snu:ti:
snooze	snu:z
snore	sno:
snorkel	`sno:k@l
snort	sno:t
snout	sna:Ut
snow	sn@U
snub	snab
snug	snag
snuggle	`snag@l
so	s@U
so-and-so	`s@U-@n-s@U
soak	s@Uk
soap	s@Up
soar	so:
sob	sOb
sober	`s@Ub@
soccer	`sOk@
social	`s@US@l
social security	s@US@ls@`kju:r@ti:
socialise	`s@US@la:Iz
socialism	`s@US@lIz@m
society	s@`sa:I@ti:
sociology	s@Usi:`Ol@dZi:
sock	sOk
socket	`sOk@t
soda	`s@Ud@
sodium	`s@Udi:@m
sodium bicarbonate	`s@Udi:@mba:I`ka:b@n@t
sofa	`s@Uf@
sofa bed	`s@Uf@bEd
soft	sOft
soggy	`sOgi:
soil	so:Il
solar	`s@Ul@
sold	s@Uld
soldier	`s@UldZ@
sole	s@Ul
solemn	`sOl@m
solicitor	s@`lIs@t@
solid	`sOl@d
solitary	`sOl@tri:
solo	`s@Ul@U
soloist	`s@Ul@U@st
soluble	`sOlj@b@l
solution	s@`lu:S@n
solve	sOlv
sombre	`sOmb@
some	sam
somebody	`sambOdi:
somehow	`samha:U
someone	`samwan
somersault	`sam@sOlt
something	`samTIN
sometime	`samta:Im
sometimes	`samta:Imz
somewhere	`samwE@
son	san
son-in-law	`san-In-lo:
song	sON
soon	su:n
soot	sUt
soothe	su:D
sophisticated	s@`fIst@kEIt@d
sopping	`sOpIN
soprano	s@`pra:n@U
sorbet	`so:bEI
sordid	`so:d@d
sore	so:
sorrow	`sOr@U
sorry	`sOri:
sort	so:t
souffle	`su:flEI
sought	so:t
soul	s@Ul
sound	sa:Und
soup	su:p
sour	`sa:U@
source	so:s
south	sa:UT
southern cross	saD@n`krOs
souvenir	su:v@`nI@
soviet	`s@Uvi:@t
sow	s@U
soya bean	`so:I@bi:n
soya sauce	`so:I@so:s
spa	spa:
space	spEIs
spacecraft	`spEIskra:ft
spacious	`spEIS@s
spade	spEId
spaghetti	sp@`gEti:
span	spAn
spanish	`spAnIS
spank	spANk
spanner	`spAn@
spare	spE@
spark	spa:k
spark plug	`spa:kplag
sparkle	`spa:k@l
sparse	spa:s
spasm	`spAz@m
spasmodic	spAz`mOdIk
spastic	`spAstIk
speak	spi:k
speaker	`spi:k@
spear	spI@
special	`spES@l
specialise	`spES@la:Iz
specialised	`spES@la:Izd
specialist	`spES@l@st
specially	`spES@li:
species	`spi:si:z
specific	sp@`sIfIk
specification	spEs@f@`kEIS@n
specify	`spEs@fa:I
specimen	`spEs@m@n
speck	spEk
spectacle	`spEkt@k@l
spectacles	`spEkt@k@lz
spectacular	spEk`tAkjUl@
spectator	spEk`tEIt@
spectrum	`spEktr@m
speculate	`spEkj@lEIt
sped	spEd
speech	spi:tS
speed	spi:d
speedometer	spi:`dOm@t@
spell	spEl
spelt	spElt
spencer	spens@
spend	spEnd
spendthrift	`spEndTrIft
sperm	sp@:m
spew	spju:
sphere	sfI@
spice	spa:Is
spider	`spa:Id@
spike	spa:Ik
spiky	spa:Iki:
spill	spIl
spin	spIn
spin drier	spIn`dra:I@
spin-dry	spIn-`dra:I
spine	spa:In
spineless	`spa:Inl@s
spinnaker	`spIn@k@
spinning wheel	`spInINwi:l
spinster	`spInst@
spiny	`spa:Ini:
spiny anteater	spa:Ini:`Anti:t@
spiral	`spa:Ir@l
spire	`spa:I@
spirit	`spIr@t
spiritual	`spIrItSu:@l
spit	spIt
spite	spa:It
spiteful	`spa:ItfUl
splash	splAS
splatter	`splAt@
spleen	spli:n
splendid	`splEnd@d
splint	splInt
splinter	`splInt@
split	splIt
split-level	`splIt-lEv@l
splutter	`splat@
spoil	spo:Il
spoke	sp@Uk
spoken	`sp@Uk@n
spokesperson	`sp@Uksp@:s@n
sponge	spandZ
sponsor	`spOns@
sponsorship	`spOns@SIp
spontaneous	spOn`tEIni:@s
spook	spu:k
spooky	`spu:ki:
spoon	spu:n
sporadic	sp@`rAdIk
sport	spo:t
sports	spo:ts
spot	spOt
spotless	`spOtl@s
spotted	`spOt@d
spotty	`spOti:
spouse	spa:Us
spout	spa:Ut
sprain	sprEIn
sprang	sprAN
sprawl	spro:l
spray	sprEI
spread	sprEd
spree	spri:
spring	sprIN
spring-clean	sprIN-`kli:n
sprinkle	`sprINk@l
sprinkler	`sprINkl@
sprint	sprInt
sprout	spra:Ut
sprouts	spra:Uts
sprung	spraN
spud	spad
spun	span
spur	sp@:
spurt	sp@:t
spy	spa:I
squabble	`skwOb@l
squad	skwOd
squalid	`skwOl@d
squander	`skwOnd@
square	skwe:
squash	skwOS
squeak	skwi:k
squeal	skwi:l
squeeze	skwi:z
squint	skwInt
squirm	skw@:m
squirt	skw@:t
stab	stAb
stable	`stEIb@l
stack	stAk
stadium	`stEIdi:@m
staff	sta:f
stage	stEIdZ
stagger	`stAg@
stagnant	`stAgn@nt
stain	stEIn
stair	stE@
staircase	`stE@kEIs
stake	stEIk
stale	stEIl
stalk	sto:k
stall	sto:l
stamina	`stAm@n@
stammer	`stAm@
stamp	stAmp
stamp duty	`stAmpdju:ti:
stampede	stAm`pi:d
stand	stAnd
stand-by	`stAnd-ba:I
standard	`stAnd@d
standing	`stAndIN
standstill	`stAndstIl
staple	`stEIp@l
stapler	`stEIpl@
star	st6:
starch	sta:tS
stare	stE@
stark	sta:k
start	st6:t
startle	`sta:tl
starve	sta:v
state	stEIt
statement	`stEItm@nt
static	`stAtIk
station	st{IS@n
station wagon	`stEIS@nwAg@n
stationary	`stEIS@nri:
stationery	`stEIS@nri:
statistics	st@`tIstIks
statue	`stAtSu:
status	`stEIt@s
statute	`stAtSu:t
statutory declaration	`stAtS@tri:dEkl@`rEIS@n
stay	stEI
std	Esti:`di:
steadfast	`stEdfa:st
steady	`stEdi:
steak	stEIk
steal	sti:l
steam	sti:m
steel	sti:l
steep	sti:p
steeple	sti:p@l
steer	stI@
steering wheel	`stI@rINwi:l
stem	stEm
stenographer	st@`nOgr@f@
step	stEp
stepfather	`stEpfa:D@
stepladder	`stEplAd@
stepmother	`stEpmaD@
stereo	`stEri:@U
sterile	`stEra:Il
sterilise	`stEr@la:Iz
stern	st@:n
stethoscope	`stET@sk@Up
stew	stju:
steward	`stju:@d
stick	stIk
sticker	`stIk@
sticky	`stIki:
stiff	stIf
stigma	`stIgm@
still	stIl
stimulant	`stImj@l@nt
stimulate	`stImj@lEIt
sting	stIN
stingy	`stIndZi:
stink	stINk
stir	st@:
stitch	stItS
stock	stOk
stock exchange	`stOkEkstSEIndZ
stocking	`stOkIN
stockman	`stOkm@n
stocky	`stOki:
stole	st@Ul
stolen	`st@Ul@n
stomach	`stam@k
stone	st@Un
stone-cold	st@Un-`k@Uld
stood	stUd
stool	stu:l
stoop	stu:p
stop	stOp
stopover	`stOp@Uv@
stopper	`stOp@
storage	`sto:rIdZ
store	sto:
storey	sto:r\i:
storm	sto:m
story	`sto:ri:
stout	sta:Ut
stove	st@Uv
straggle	strAgl
straight	str\{It
straightaway	strEIt@`wEI
straightforward	strEIt`fo:w@d
strain	strEIn
strained	strEInd
strand	strAnd
strange	strEIndZ
stranger	`strEIndZ@
strangle	`strANgl
strap	strAp
strategic	str@`ti:dZIk
strategy	`strAt@dZi:
straw	stro:
stray	strEI
streak	stri:k
stream	stri:m
streamer	`stri:m@
street	str\i:t
strength	strENT
strenuous	`strEnju:@s
stress	strEs
stretch	strEtS
stricken	`strIk@n
strict	strIkt
stride	stra:Id
strife	stra:If
strike	stra:Ik
striking	`stra:IkIN
string	strIN
strip	strIp
stripe	stra:Ip
stripper	`strIp@
strive	stra:Iv
strode	str@Ud
stroke	str@Uk
stroll	str@Ul
stroller	`str@Ul@
strong	strON
strove	str@Uv
struck	strak
structure	`straktS@
struggle	`strag@l
stub	stab
stubborn	`stab@n
stubby	`stabi:
stuck	stak
stuck-up	`stak-ap
student	`stju:dnt
studio	`stju:di:@U
study	`stadi:
stuff	staf
stuffing	`stafIN
stuffy	`stafi:
stumble	`stamb@l
stump	stamp
stumpy	`stampi:
stun	stan
stung	staN
stunning	`stanIN
stupid	`stju:p@d
sturdy	`st@:di:
stutter	`stat@
style	sta:Il
stylish	`sta:IlIS
subdivide	`sabd@va:Id
subdue	s@b`dju:
subdued	s@b`dju:d
subject	`sabdZEkt
submarine	`sabm@ri:n
submerge	s@b`m@:dZ
submit	s@b`mIt
subordinate	s@`bo:d@n@t.
subscribe	s@b`skra:Ib
subscriber	s@b`skra:Ib@
subscription	s@b`skrIpS@n
subsequent	`sabs@kw@nt
subside	s@b`sa:Id
subsidiary	s@b`sIdZ@ri:
subsidy	`sabs@di:
substance	`sabst@ns
substantial	s@b`stAnS@l
substitute	`sabst@tSu:t
subtitle	`sabta:Itl
subtle	`satl
subtract	s@b`trAkt
suburb	`sab@:b
suburbia	s@`b@:bi:@.
succeed	s@k`si:d
success	s@k`sEs
such	satS
suck	sak
sudden	`sadn
suds	sadz
sue	su:
suede	swEId
suffer	`saf@
suffering	`saf@rIN
sufficient	s@`fIS@nt
suffix	`safIks
suffocate	`saf@kEIt
sugar	`SUg@
suggest	s@`dZEst
suicidal	su:@`sa:Idl
suicide	`su:@sa:Id
suit	su:t
suitable	`su:t@b@l
suitcase	`su:tkEIs
suite	swi:t
suited	`su:t@d
sulk	salk
sullen	`sal@n
sultana	sal`ta:n@
sultry	`saltri:
sum	sam
summary	`sam@ri:
summer	`sam@
summit	`sam@t
summon	`sam@n
summons	`sam@nz
sumptuous	`samptSu:@s
sun	san
sunbake	`sanbEIk
sunburn	`sanb@:n
sunday	`sandEI
sundry	`sandri:
sung	saN
sunglasses	`sangla:s@z
sunk	saNk
sunken	`saNk@n
sunlight	`sanla:It
sunny	`sani:
sunrise	`sanra:Iz
sunscreen	`sanskri:n
sunset	`sansEt
sunshine	`sanSa:In
sunstroke	`sanstr@Uk
suntan	`santAn
super	`su:p@
superannuation	`su:p@rAnju:`EIS@n
superb	s@`p@:b
superficial	su:p@`fIS@l
superintendent	su:p@rIn`tEnd@nt
superior	s@`pI@ri:@
superlative	su:`p@:l@tIv
supermarket	`su:p@ma:k@t
superstitious	su:p@`stIS@s
supervise	`su:p@va:Iz
supper	`sap@
supple	`sap@l
supplement	`sapl@m@nt
supply	s@`pla:I
support	s@`po:t
supportive	s@`po:tIv
suppose	s@`p@Uz
supposed	s@`p@Uzd
suppress	s@`prEs
supreme	s@`pri:m
sure	So:
surely	`So:li:
surf	s@:f
surface	`s@:f@s
surfboard	`s@:fbo:d
surge	s@:dZ
surgeon	`s@:dZ@n
surgery	`s@:dZ@ri:
surly	`s@:li:
surname	`s@:nEIm
surpass	s@`pa:s
surplus	`s@:pl@s
surprise	s@`pra:Iz
surrender	s@`rEnd@
surround	s@`ra:Und
surroundings	s@`ra:UndINz
survey	s@`vEI
surveyor	s@`vEI@
survive	s@`va:Iv
suspect	s@`spEkt
suspend	s@`spEnd
suspense	s@`spEns
suspension	s@`spEnS@n
suspicion	s@`spIS@n
suspicious	s@`spIS@s
suss	sas
sustain	s@`stEIn
swag	swAg
swagger	`swAg@
swallow	`swOl@U
swam	swAm
swamp	swOmp
swap	swOp
swarm	swo:m
swarthy	`swo:Di:
swat	swOt
sway	swEI
swear	swE@
sweat	swEt
sweater	`swEt@
sweep	swi:p
sweeping	`swi:pIN
sweet	swi:t
sweeten	`swi:tn
sweetheart	`swi:tha:t
swell	swEl
swelling	`swElIN
swept	swEpt
swerve	sw@:v
swift	swIft
swim	swIm
swimmers	`swIm@z
swimming pool	`swImINpu:l
swimsuit	`swImsu:t
swindle	`swIndl
swing	swIN
swipe	swa:Ip
switch	swItS
switchboard	`swItSbo:d
swollen	`sw@Ul@n
swoop	swu:p
sword	so:d
swore	swo:
sworn	swo:n
swum	swam
swung	swaN
sycamore	sIk@mo:
syllable	`sIl@b@l
syllabus	`sIl@b@s
symbol	`sImb@l
symmetry	`sIm@tri:
sympathy	`sImp@Ti:
symphony	`sImf@ni:
symptom	`sImpt@m
synagogue	`sIn@gOg
syndicate	`sIndIk@t
synonym	`sIn@nIm
synopsis	s@`nOps@s
synthetic	sIn`TEtIk
syringe	s@`rIndZ
syrup	`sIr@p
system	`sIst@m
t	ti:
t-shirt	`ti:-S@:t
ta	ta:
tab	tAb
tabby	`tAbi:
table	`tEIb@l
table tennis	`tEIbltEn@s
tablecloth	`tEIb@lklOT
tablespoon	`tEIb@lspu:n
tablet	`tAbl@t
tableware	`tEIb@lwE@
tabloid	`tAblo:Id
taboo	t@`bu:
tabulate	`tAbj@lEIt
tacit	`tAs@t
taciturn	`tAs@t@:n
tack	tAk
tackle	`tAk@l
tacky	`tAki:
tact	tAkt
tactic	`tAktIk
tactics	`tAktIks
tafe	tEIf
tag	tAg
tail	tEIl
tailor	`tEIl@
taipan	`ta:IpAn
take	tEIk
take-off	`tEIk-Of
takeaway	`tEIk@wEI
takings	`tEIkINz
talcum powder	`tAlk@mpa:Ud@
tale	tEIl
talent	`tAl@nt
talk	to:k
talkback	`to:kbAk
tall	to:l
tally	`tAli:
talon	`tAl@n
tame	tEIm
tamper	`tAmp@
tampon	`tAmpOn
tan	tAn
tandem	`tAnd@m
tang	tAN
tangent	`tAndZ@nt
tangerine	tAndZ@`ri:n
tangible	`tAndZ@b@l
tangle	`tANg@l
tank	tANk
tankard	`tANk@d
tanker	`tANk@
tantalise	`tAnt@la:Iz
tantamount	`tAnt@ma:Unt
tantrum	`tAntr@m
tap	tAp
tape	tEIp
tape-recorder	`tEIp-r@ko:d@
taper	`tEIp@
tapestry	`tAp@stri:
tar	ta:
target	`tAg@t
tariff	`tAr@f
tarmac	`ta:mAk
tarnish	`ta:nIS
tarpaulin	ta:`po:l@n
tarragon	`tAr@g@n
tart	ta:t
tartan	`ta:t@n
tas.	tAz`mEInj@
task	ta:sk
tassel	`tAs@l
taste	tEIst
tasteful	`tEIstfUl
tasteless	`tEIstl@s
tasty	`tEIsti:
tattered	`tAt@d
tatters	`tAt@z
tattoo	tA`tu:
tatty	`tAti:
taught	to:t
taunt	to:nt
taut	to:t
tautology	to:`tOl@dZi:
tavern	`tAv@n
tawdry	`to:dri:
tawny	`to:ni:
tax	tAks
taxi	`tAksi:
tea	ti:
tea towel	`ti:ta:Ul
teabag	`ti:bAg
teach	ti:tS
teacher	`ti:tS@
teachers aide	`ti:tS@zEId
team	ti:m
teapot	`ti:pOt
tear	tI@
tease	ti:z
teaspoon	`ti:spu:n
teat	ti:t
tech	tEk
technical	`tEknIk@l
technical college	`tEknIk@lkOlIdZ
technician	tEk`nIS@n
technique	tEk`ni:k
technology	tEk`nOl@dZi:
teddy bear	`tEdi:bE@
tedious	`ti:di:@s
tee	ti:
teem	ti:m
teenager	`ti:nEIdZ@
teens	ti:nz
teeth	ti:T
teetotal	`ti:t@Utl
telecast	`tEl@ka:st
telecommunications	tEl@k@mju:n@`kEIS@ns
telepathy	t@`lEp@Ti:
telephone	`tEl@f@Un
telephone exchange	`tEl@f@UnEks`tSEIndZ
telescope	`tEl@sk@Up
television	`tEl@vIZ@n
tell	tEl
teller	`tEl@
temper	`tEmp@
temperament	`tEmpr@m@nt
temperamental	tEmpr@`mEntl
temperature	`tEmpr@tS@
temporary	`tEmpri:
tempt	tEmpt
ten	tEn
tenacious	t@`nEIS@s
tenant	`tEn@nt
tend	tEnd
tender	`tEnd@
tendon	`tEnd@n
tenement	`tEn@m@nt
tennis	`tEn@s
tenor	`tEn@
tense	tEns
tent	tEnt
tentacle	`tEnt@k@l
tentative	`tEnt@tIv
tenth	tEnT
tenuous	`tEnju:@s
tepid	`tEp@d
term	t@:m
terminal	`t@:m@n@l
terminate	`t@:m@nEIt
terminology	t@:m@`nOl@dZi:
terminus	`t@:m@n@s
termite	`t@:ma:It
terrace	`tEr@s
terrain	t@`rEIn
terrestrial	t@`rEstri:@l
terrible	`tEr@b@l
terribly	`tEr@bli:
terrific	t@`rIfIk
terrify	`tEr@fa:I
territory	`tEr@tri:
terror	`tEr@
terrorise	`tEr@ra:Iz
terrorism	`tEr@rIz@m
terse	t@:s
tertiary	`t@:S@ri:
test	tEst
testament	`tEst@m@nt
testicle	`tEstIk@l
testify	`tEst@fa:I
testimonial	tEst@`m@Uni:@l
testimony	`tEst@m@ni:
tether	`tED@
text	tEkst
texta	`tEkst@
textbook	`tEkstbUk
textile	`tEksta:Il
texture	`tEkstS@
thai	ta:I
than	DAn
thank	TANk
that	DAt
thatch	TAtS
thaw	To:
the	D@
theatre	TI@t@
theatrical	Ti:`Atr@k@l
theft	TEft
their	DE@
theirs	DE@z
them	DEm
theme	Ti:m
themselves	D@m`sElvz
then	DEn
theology	Ti:`Ol@dZi:
theorem	`TI@r@m
theory	`TI@ri:
therapeutic	TEr@`pju:tIk
therapy	`TEr@pi:
there	DE@
thereabouts	DE@r@`ba:Uts
thereafter	DE@r`a:ft@
thereby	DE@`ba:I
therefore	`DE@fo:
therell	DE@l
thereupon	DE@r@`pOn
thermometer	T@`mOm@t@
thermos	`T@:mOs
thermostat	`T@:m@stAt
thesaurus	T@`so:r@s
these	Di:z
thesis	`Ti:s@s
they	DEI
thick	TIk
thicket	`TIk@t
thief	Ti:f
thigh	Ta:I
thimble	`TImb@l
thin	TIn
thing	TIN
think	TINk
third	T@:d
thirst	T@:st
thirteen	T@:`ti:n
thirteenth	T@:`ti:nT
thirty	`T@:ti:
this	DIs
thistle	`TIs@l
thong	TON
thorn	To:n
thorough	`Tar@
thoroughfare	`Tar@fE@
thoroughly	`Tar@li:
those	D@Uz
though	D@U
thought	To:t
thoughtful	`To:tfUl
thoughtless	`To:tl@s
thousand	`Ta:Uz@nd
thousandth	`Ta:Uz@nT
thrash	TrAS
thread	TrEd
threadbare	`TrEdbE@
threat	TrEt
threaten	`TrEt@n
three	Tr\i:
three-dimensional	Tri:-d`mEnS@n@l
thresh	TrES
threshold	`TrESh@Uld
threw	Tru:
thrift	TrIft
thrifty	Tr\Ifti:
thrill	TrIl
thriller	`TrIl@
thrive	Tra:Iv
throat	Tr@Ut
throb	TrOb
throne	Tr@Un
throng	TrON
throttle	`TrOtl
through	Tru:
throughout	Tru:`a:Ut
throw	Tr@U
thrust	Trast
thud	Tad
thug	Tag
thumb	Tam
thump	Tamp
thunder	`Tand@
thursday	`T@:zdEI
thus	Das
thwart	Two:t
thyme	ta:Im
thyroid	`Ta:Iro:Id
tick	tIk
ticket	`tIk@t
tickle	`tIk@l
ticklish	`tIklIS
tiddly	`tIdli:
tide	ta:Id
tidy	`ta:Idi:
tie	ta:I
tier	`tI@
tiger snake	`ta:Ig@snEIk
tight	ta:It
tights	ta:Its
tile	ta:Il
till	tIl
tilt	tIlt
timber	`tImb@
time	ta:Im
timely	`ta:Imli:
timetable	`ta:ImtEIb@l
timid	`tIm@d
tin	tIn
tinea	`tIni:@
tinge	tInZ
tingle	`tINg@l
tinker	`tINk@
tinkle	`tINk@l
tinnie	`tIni:
tinny	`tIni:
tinsel	`tIns@l
tint	tInt
tiny	`ta:Ini:
tip	tIp
tipsy	`tIpsi:
tirade	ta:I`rEId
tire	ta:I@
tired	ta:I@d
tiring	`ta:I@rIN
tissue	`tISu:
tit	tIt
titbit	`tItbIt
title	`ta:Itl
titter	`tIt@
to	tu:
toad	t@Ud
toadstool	`t@Udstu:l
toast	t@Ust
toaster	`t@Ust@
tobacco	t@`bAk@U
toboggan	t@`bOg@n
today	t@`dEI
toddle	`tOdl
toddler	`tOdl@
toe	t@U
together	t@`gED@
toil	to:Il
toilet	`to:Il@t
toiletries	`to:Il@tri:z
token	`t@Uk@n
told	t@Uld
tolerable	`tOlr@bl
tolerant	`tOl@r@nt
tolerate	`tOl@rEIt
toll	t@Ul
tomato	t@`ma:t@U
tomb	tu:m
tombstone	`tu:mst@Un
tomcat	`tOmkAt
tomorrow	t@`mOr@U
ton	tan
tone	t@Un
tongue	taN
tonic	`tOnIk
tonight	t@`na:It
tonne	tOn
tonsil	`tOns@l
tonsilitis	tOns@`la:It@s
too	tu:
took	tUk
tool	tu:l
toot	tu:t
tooth	tu:T
toothache	`tu:TEIk
toothbrush	`tu:TbraS
toothpaste	`tu:TpEIst
toothpick	`tu:TpIk
top	tOp
topic	`tOpIk
topical	`tOpIkl
topless	`tOpl@s
topping	`tOpIN
topple	`tOpl
torch	to:tS
tore	to:
torment	`to:mEnt
torn	to:n
tortuous	`to:tSu:@s
torture	`to:tS@
toss	tOs
total	`t@Ut@l
totalitarian	t@U;tAl@`tE@ri:@n
totem	`t@Ut@m
totter	`tOt@
touch	tatS
touchy	`tatSi:
tough	taf
tour	tU@
tourism	`to:rIzm
tourist	`to:rIst
tournament	`to:n@m@nt
tow	t@U
towards	t@`wo:dz
towel	`ta:U@l
tower	t{O@
town	t{On
town hall	ta:Un`ho:l
toxic	`tOksIk
toxin	`tOks@n
toy	to:I
trace	trEIs
track	trAk
tracksuit	`trAksu:t
tractor	`trAkt@
trade	trEId
trade union	trEId`ju:nj@n
trade-in	`trEId-In
trademark	`trEIdma:k
tradition	tr@`dIS@n
traffic	`trAfIk
traffic jam	`trAfIkdZAm
tragedy	`trAdZ@di:
tragic	`trAdZIk
trail	trEIl
trailer	`trEIl@
train	trEIn
trainee	trEI`ni:
training	`trEInIN
trait	trEIt
traitor	`trEIt@
tram	trAm
trample	`trAmp@l
tranquil	`trANkw@l
tranquilliser	`trANkw@la:Iz@
transfer	trAns`f@:
transform	trAns`fo:m
transfusion	trAns`fju:Z@n
transitive	`trAns@tIv
translate	trAnz`lEIt
transmit	trAnz`mIt
transparent	trAn`spE@r@nt
transplant	trAn`splAnt
transport	`trAnspo:t
trap	trAp
trauma	`tro:m@
travel	`trAv@l
travel agent	`trAv@lEIdZ@nt
tray	trEI
treacherous	`trEtS@r@s
treachery	`trEtS@ri:
tread	trEd
treasure	`trEZ@
treasurer	`trEZ@r@
treat	tri:t
tree	tr\i:
tremble	`trEmb@l
tremendous	tr@`mEnd@s
trend	trEnd
trendy	tr\endi:
trespass	`trEsp@s
trial	tra:I@l
triangle	`tra:IANgl
tribunal	tr@`bju:n@l
trick	trIk
trickle	`trIkl
tried	tra:Id
trim	trIm
trip	trIp
triple	`trIpl
triumph	`tra:Iamf
trivial	`trIvi:@l
trod	trOd
trodden	`trOdn
trolley	`trOli:
troop	tru:p
tropical	`trOpIkl
tropics	`trOpIks
trouble	`trabl
trousers	`tra:Uz@z
truck	trak
trudge	tradZ
true	tru:
trumpet	`tramp@t
trunk	traNk
trust	trast
trustworthy	`trastw@:Di:
truth	tru:T
truthful	`tru:TfUl
try	tra:I
tube	tju:b
tuck	tak
tuesday	`tju:zdEI
tuft	taft
tug	tag
tuition	tju:`ISn
tumble	`tambl
tumour	`tju:m@
tuna	`tju:n@
tune	tju:n
tunnel	t6n@l
turkish	`t@:kIS
turn	t@:n
turquoise	`t@:kwo:Iz
tutor	`tju:t@
tv	ti:`vi:
tweezers	`twi:z@z
twelfth	twElfT
twelve	twElv
twentieth	`twEnti:@T
twenty	`twEnti:
twice	twa:Is
twig	twIg
twilight	`twa:Ila:It
twin	twIn
twinge	twIndZ
twinkle	`twINkl.
twist	twIst
two	t}:
tying	`ta:IIN
type	ta:Ip
typewriter	`ta:Ipra:It@
typhoid	`ta:Ifo:Id
typhoon	ta:I`fu:n
typical	`tIpIkl
typically	`tIpIkli:
tyre	ta:I@
u	ju:
ugly	`agli:
ulcer	`als@
ultimate	`alt@m@t
um	am
umbrella	am`brEl@
umpire	`ampa:I@
umpteen	amp`ti:n
unanimous	ju:`nAn@m@s
uncanny	an`kAni:
uncle	`aNk@l
unconscious	an`kOnS@s
under	`and@
underarm	`and@ra:m
underdone	and@`dan
undergo	and@`g@U
undergrowth	`u:nd@gr@UT
underhand	`and@hAnd
underline	and@`la:In
underneath	and@`ni:T
underpants	`and@pAnts
understand	and@`stAnd
understate	and@`stEIt
undertake	and@`tEIk
undertaker	`and@tEIk@
underwear	`and@wE@
undo	an`du:
uneasy	an`i:zi:
unemployed	an@m`plo:Id
uneventful	an@`vEntfUl
unforgettable	anf@`gEt@b@l
uniform	`ju:.n@fo:m
unify	`ju:n@fa:I
unilateral	ju:ni:`lAt@r@l
uninterested	an`Intr@st@d
union	`ju:nj@n
unique	ju:`ni:k
unisex	`ju:ni:sEks
unison	`ju:n@s@n
unit	`ju:n@t
unite	ju:`na:It
universal	ju:n@`v@:s@l
universe	`ju:n@v@:s
university	ju:n@`v@:s@ti:
unknown	an`n@Un
unlawful	an`lo:fUl
unless	an`lEs
unravel	an`rAv@l
unreal	an`ri:l
unrest	an`rEst
unscathed	an`skEIDd
unscrew	an`skru:
unscrupulous	an`skru:pjUl@s
unsettle	an`sEtl
untangle	an`tANgl
unthinkable	an`TINk@b@l
untie	an`ta:I
until	an`tIl
unusual	an`ju:Zu:@l
unwieldy	an`wIldi:
up	6p
up-market	`ap-ma:k@t
up-to-date	ap-t@-`dEIt
upbringing	`apbrININ
update	ap`dEIt
upgrade	ap`grEId
upheaval	ap`hi:v@l
uphill	ap`hIl
uphold	ap`h@Uld
upholstery	ap`h@Ulstri:
upkeep	`apki:p
upon	@`pOn
upper	`ap@
uppermost	`ap@m@Ust
upright	`apra:It
uprising	`apra:IzIN
uproar	`apro:
uproarious	ap`ro:ri:@s
upset	ap`sEt
upside down	apsa:Id`da:Un
upstairs	ap`stE@z
upstream	ap`stri:m
uptight	ap`ta:It
upturn	`apt@:n
upward	`apw@d
upwards	`apw@dz
upwind	ap`wInd
uranium	ju:`rEIni:@m
urban	`@:b@n
urbane	@:`bEIn
urge	@:dZ
urgent	`@:dZ@nt
urinal	`ju:r@n@l
urine	`ju:r@n
urn	@:n
us	as
use	ju:z
used	ju:st
usual	`ju:Zu:@l
ute	ju:t
utensil	ju:`tEns@l
uterus	`ju:t@r@s
utilities	ju:`tIl@ti:z
utility truck	ju:`tIl@ti:trak
utter	`at@
v	`v@:s@s
vacancy	`vEIk@nsi:
vacant	`vEIk@nt
vacation	v@`kEIS@n
vaccine	`vAksi:n
vacuum	`vAkju:m
vagina	v@`dZa:In@
vague	vEIg
vain	vEIn
valid	`vAl@d
valley	`vAli:
valuable	`vAlju:b@l
value	`vAlju:
valve	vAlv
van	vAn
vandal	`vAnd@l
vanilla	v@`nIl@
vanish	`vAnIS
vanity	`vAn@ti:
vapour	`vEIp@
variety	v@`ra:I@ti:
various	`vE@ri:@s
varnish	`va:nIS
vary	`vE@ri:
vase	va:z
vast	va:st
vat	vAt
vcr	vi:si:`a:
vdu	vi:di:`ju:
veal	vi:l
vegan	`vi:g@n
vegetable	`vEdZt@b@l
vegetarian	vEdZ@`tE@ri:@n
vegetation	vEdZ@`tEIS@n
vegie	`vEdZi:
vehement	`vi:@m@nt
vehicle	`vi:Ik@l
veil	vEIl
vein	vEIn
velvet	`vElv@t
veneer	v@`nI@
venereal disease	v@`nI@ri:@ld@zi:z
vengeance	`vEndZ@ns
venom	`vEn@m
ventilate	`vEnt@lEIt
venture	`vEntS@
venue	`vEnju:
veranda	v@`rAnd@
verb	v@:b
verbal	`v@:b@l
verdict	`v@:dIkt
verify	`vEr@fa:I
versatile	`v@:s@ta:Il
verse	v@:s
version	`v@:Z@n
versus	`v@:s@s
vertebra	`v@:t@br@
vertical	`v@:tIk@l
very	`vEri:
vessel	`vEs@l
vet	vEt
veto	`vi:t@U
vex	vEks
via	`va:I@
vibrate	va:I`brEIt
vic.	vIk`to:ri:@
vice	va:Is
vice versa	va:Is@`v@:s@
vicinity	v@`sIn@ti:
vicious	`vIS@s
victim	`vIkt@m
victimise	`vIkt@ma:Iz
victory	`vIkt@ri:
video	`vIdi:@U
videotape	`vIdi:@UtEIp
vietnamese	vi:;Etn@`mi:z
view	vju:
viewer	`vju:@
vigorous	`vIg@r@s
vile	va:Il
village	`vIlIdZ
villain	`vIl@n
vindictive	vIn`dIktIv
vine	va:In
vinegar	`vInIg@
vineyard	`vInj@d
vintage	`vIntIdZ
vinyl	`va:In@l
violent	`va:I@l@nt
violin	va:I@`lIn
vip	vi:a:I`pi:
virgin	`v@:dZ@n
virile	`vIra:Il
virtue	`v@:tSu:
virulent	`vIr@l@nt
virus	`va:Ir@s
visa	`vi:z@
visible	`vIz@b@l
vision	`vIZ@n
visit	`vIz@t
visual	`vIZu:@l
visual display unit	;vIZju:@ld@`splEIju:n@t
visualise	`vIZj@la:Iz
vital	`va:It@l
vitality	va:I`tAl@ti:
vitamin	`va:It@m@n
vivacious	v@`vEIS@s
vivid	`vIv@d
vocabulary	v@`kAbj@l@ri:
vocal	`v@Uk@l
vocalist	`v@Uk@l@st
vogue	v@Ug
voice	vo:Is
void	vo:Id
volcano	vOl`kEIn@U
volley	`vOli:
volleyball	`vOli:bo:l
volume	`vOlju:m
voluntary	`vOl@ntri:
volunteer	vOl@n`tI@
vomit	`vOm@t
vote	v@Ut
voucher	`va:UtS@
vow	va:U
vowel	`va:U@l
voyage	`vo:IIdZ
vs	`v@:s@s
vulgar	`valg@
vulnerable	`valnr@b@l
w	wEst
wa	wEst@n@`strEIlj@
wad	wOd
waddle	`wOdl
wade	wEId
wafer	`wEIf@
wag	wAg
wage	wEIdZ
wager	`wEIdZ@
wail	wEIl
waist	wEIst
wait	wEIt
waiter	`wEIt@
wake	wEIk
walk	wo:k
walkover	`wo:k@Uv@
wall	wo:l
wallet	`wOl@t
wallpaper	`wo:lpEIp@
waltz	wo:ls
wander	`wOnd@
wane	wEIn
wangle	`wANg@l
wank	wAnk
want	wOnt
war	wo:
ward	wo:d
warden	`wo:d@n
warder	`wo:d@
wardrobe	`wo:dr@Ub
warehouse	`wE@ha:Us
warfare	`wo:fE@
warm	wo:m
warn	wo:n
warning	`wo:nIN
warp	wo:p
warped	wo:pt
warrant	`wOr@nt
warranty	`wOr@nti:
wart	wo:t
wary	`wE@ri:
was	wOz
wash	wOS
washed-out	`wOSt-a:Ut
washer	`wOS@
waste	wEIst
wastepaper basket	wEIst`pEIp@ba:sk@t
watch	wOtS
water	wo:t@
watercolour	`wo:t@kal@
waterfront	`wo:t@frant
waterlogged	`wo:t@lOgd
waterproof	`wo:t@pru:f
waterski	`wo:t@ski:
watertight	`wo:t@ta:It
watt	wOt
wattle	wOt@l
wave	wEIv
wax	wAks
way	wEI
way-out	`wEI-a:Ut
we	wi:
weak	wi:k
wealth	wElT
wealthy	`wElTi:
weapon	`wEp@n
wear	wE@
weary	`wI@ri:
weather	`wED@
weave	wi:v
web	wEb
webbed	wEbd
wedding	`wEdIN
wedge	wEdZ
wednesday	`wEnzdEI
weed	wi:d
week	wi:k
weekday	`wi:kdEI
weekend	wi:k`End
weekly	`wi:kli:
weep	wi:p
weigh	wEI
weight	wEIt
weird	wI@d
welcome	`wElk@m
weld	wEld
welfare	`wElfE@
well	wEl
well-off	wEl-`Of
wellbeing	`wElbi:IN
went	wEnt
wept	wEpt
were	w@:
werent	w@:nt
west	west
western	`wEst@n
wet	wEt
whack	wAk
wharf	wo:f
what	wOt
whatever	wOt`Ev@
whatsoever	wOts@U`Ev@
wheat	wi:t
wheel	wi:l
wheelbarrow	`wi:lbAr@U
wheelchair	`wi:ltSE@
when	wEn
whenever	wEn`Ev@
where	wE@
whereabouts	`wE@r@ba:Uts
whereas	wE@r`Az
wherever	wE@r`Ev@
whether	`wED@
which	wItS
whiff	wIf
while	wa:Il
whim	wIm
whimper	`wImp@
whine	wa:In
whinge	wIndZ
whip	wIp
whirl	w@:l
whirlwind	`w@:lwInd
whirr	w@:
whisk	wIsk
whisker	`wIsk@
whisky	`wIski:
whisper	`wIsp@
whistle	`wIsl
white	wa:It
white ant	`wa:ItAnt
white-ant	`wa:ItAnt
white-out	`wa:Ita:Ut
whitewash	`wa:ItwOS
whiz	wIz
who	hu:
whoever	hu:`Ev@
whole	h@Ul
wholemeal	`h@Ulmi:l
wholesale	`h@UlsEIl
wholesome	`h@Ulsam
whom	hu:m
whopping	`wOpIN
whore	ho:
whose	hu:z
why	wa:I
wick	wIk
wicked	`wIk@d
wicket	`wIk@t
wide	wa:Id
widespread	`wa:IdsprEd
widow	`wId@U
widower	`wId@U@
wife	wa:If
wig	wIg
wiggle	`wIg@l
wild	wa:Ild
wild flower	`wa:Ildfla:U@
wilderness	`wIld@nEs
wildlife	`wa:Ildla:If
wilful	`wIlfo:l
will	wIl
willing	`wIlIN
willpower	`wIlpa:U@
wilt	wIlt
wily	`wa:Ili:
wimp	wImp
win	wIn
wince	wIns
wind	wInd
window	`wInd@U
window shopping	`wInd@U;SOpIN
windows	wInd@}z
windowsill	`wInd@UsIl
windpipe	`wIndpa:Ip
windscreen	`wIndskri:n
windsurf	`wInds@:f
windy	`wIndi:
wine	wa:In
wing	wIN
wink	wINk
winning	`wInIN
winter	`wInt@
wipe	wa:Ip
wire	`wa:I@
wiry	`wa:I@ri:
wisdom tooth	`wIzd@mtu:T
wise	wa:Iz
wish	wIS
wishy-washy	`wISi:-wOSi:
wit	wIt
witch	wItS
with	wIT
withdraw	wID`dro:
withhold	wID`h@Uld
within	wID`In
without	wID`a:Ut
witness	`wItn@s
wizard	`wIz@d
wobble	`wOb@l
woe	w@U
woeful	`w@UfUl
wog	wOg
wok	wOk
woke	w@Uk
wolf	wUlf
woman	`wUm@n
womb	wu:m
wombat	`wOmbAt
won	wan
wonder	`wand@
wonderful	`wand@fUl
wood	wUd
wooden	wUd@n
woodwork	`wUdw@:k
wool	wUl
word	w@:d
word processor	`w@:dpr@UsEs@
wore	wo:
work	w@:k
workbench	`w@:kbEntS
workforce	`w@:kfo:s
workload	`w@:kl@Ud
workout	`w@:ka:Ut
workplace	`w@:kplEIs
workshop	`w@:kSOp
world	w@:ld
worldwide	w@:l`dwa:Id
worm	w@:m
worn	wo:n
worn-out	wo:n-`a:Ut
worry	`wari:
worse	w@:s
worship	`w@:SIp
worst	w@:st
worth	w@:T
worthwhile	w@:T`wa:Il
worthy	`w@:Di:
would	wUd
wound	wa:Und
woven	`w@Uv@n
wow	wa:U
wowser	`wa:Uz@
wrap	rAp
wreath	ri:T
wreck	rEk
wrestle	`rEs@l
wretch	rEtS
wriggle	`rIgl
wring	rIN
wrinkle	`rINk@l
wrist	rIst
write	ra:It
write-off	`ra:It-@f
wrong	rON
wrote	r@Ut
wrung	raN
wuss	wUs
x	Eks
x-ray	`Eks-rEI
xmas	`krIsm@s
y	wa:I
yacht	jOt
yak	jAk
yakka	`jAk@
yank	jANk
yap	jAp
yard	ja:d
yarn	ja:n
yawn	jo:n
yd	ja:d
yeah	jE@
year	jI@
yeast	ji:st
yell	jEl
yellow	jel@}
yelp	jElp
yen	jEn
yes	jEs
yesterday	`jEst@dEI
yet	jEt
yield	ji:ld
yoga	`j@Ug@
yoghurt	`j@Ug@t
yolk	j@Uk
yonks	jONks
you	ju:
young	jaN
youngster	`jaNst@
your	jo:
yours	jo:z
yourself	jo:`sElf
youth	ju:T
yr	jI@
yuk	jak
yuppie	`japi:
z	zEd
zeal	zi:l
zero	`zI@r@U
zest	zEst
zigzag	`zIgzAg
zinc	zINk
zip	zIp
zodiac	`z@Udi:Ak
zombie	`zOmbi:
zone	z@Un
zoo	zu:
zoology	z@U`Ol@dZi:
zoom	zu:m
zucchini	z@`ki:ni:
